NO      ./graphic/NO.png
SO      ./graphic/SO.png
WE      ./graphic/WE.png
EA      ./graphic/EA.png
DO      ./graphic/DO.png

F 106,98,107
C 190,194,217

                                                            
                                                            
                                                            
                                                            
                                                            
                                                            
                                                            
                                                            
                                                            
                                                            
                                                            
                                                            
                                                            
                                                            
                                                            
                                                            
                                                            
                                         111111111          
                                    111110000000001         
                                   1000000000000001         
                                   1000000000000001         
                                   1000000000D00001         
                                   1000000000000001         
                                   1000000000000001         
                                   1000000000000001         
                                   1000000000000001         
                                   100000000000111          
                                   1000000000001            
      111111111                    100000000011             
     10000000001                    111000001               
     10000000001                      1000001               
     1000000000111111111111111111111111000001               
     1000000000000000000000000000000000000001               
     10000W00000000000000000000000000000000011111111        
     100000000000000000000000000000000000001000000001       
     100000000011111111111111111111111100001000000001       
     10000000001                      100001000000001       
     10000000001                      100000000000001       
      111111111                      1100000000000001       
                                    10000000000000001       
                                    10000000000000001       
                                    10000000000000001       
                                    10000000000000001       
                                    10000000000000001       
                                    1000000000111111        
                                    10000000001             
                                    10000000001             
                                     111111111              
                                                            
                                                            
                                                            
                                                            
                                                            
                                                            
                                                            
                                                            
