


NO      ./graphic/NO.png




SO ./graphic/SO.png




WE ./graphic/WE.png



EA ./graphic/EA.png



DO ./graphic/DO.png





F 22,100,0
C 22,30,0
















11111111111111111111111111111111111111111
10000000000000000000000000000000000000001
10000000000000000000000000000000000000001
10000000000000000000000000000000000000001
10000000000000000000000000000000000000001
1000000000000000000N000000000000000000001
10000000000000000000000000000000000000001
10000000000000000000000000000000000000001
10000000000000000000000000000000000000001
10000000000000000000000000000000000000001
11111111111111111111111111111111111111111
