


NO      ./graphic/NO.png




SO ./graphic/SO.png




WE ./graphic/WE.png



EA ./graphic/EA.png



DO ./graphic/DO.png

F 220,100,0
C 220,100,0

1111111111111111111111111
00000000001100000000000011111111011
10110000011100000000000011000000001
10010000000000000000000011011111111
11111111101100000111000000000000111
10000000001100000111011000000111111
11110111111111011100000111111
11110111111111011101010010001
11000000110101011100000010001
100000000000000011000000100011
100000000000000011010100100001
11000001110101011111011110N001
11110111 1110101 101111010001
11111111 1111111 111111111111
