


NO      ./graphic/NO.xpm




SO ./graphic/SO.xpm




WE ./graphic/WE.xpm



EA ./graphic/EA.xpm



DO ./graphic/DO.xpm





F 220,100,0
C 225,30,0
















1111111111111111111111111
1000000000110000000000001
1011000001110000000000001
100100000000000000000000111111111
111111111011000001110000000000001
100000000011000001110111111111111
111101111111110111000000000001
111101111111110111010100000001
110000001101010111000000000001
1000000000000000DD00000000000111111111111111
10000000000000001101010000000000000000000001
11000001110101011111011110W01111111111111111
11110111 1110101 101111010001
11111111 1111111 111111111111
