


NO      ./graphic/NO.png




SO ./graphic/SO.png




WE ./graphic/WE.png



EA ./graphic/EA.png



DO ./graphic/DO.png





F 50,30,90
C 22,150,90














1111111111111111111111111
1000000000110000000000001
1011000001110000000000001
100100000000000000000000111111111
111111111011000001110000000000001
100000000011000001110111111111111
111101111111110111000000000001
111101111111110111010100000001
110000001101010111000000000001111111
1000000000000000DD0000000000011000011111111111111111
10000000000000001101010000000200W0000000001111111111111111
1100000111010101111101111000111000011111111111111111
11110111 1110101 1011110100011111111
11111111 1111111 111111111111
