


NO      ./graphic/pack_cr7/WE.png




SO ./graphic/pack_cr7/SO.png




WE ./graphic/pack_cr7/EA.png



EA ./graphic/pack_cr7/NO.png



DO ./graphic/pack_cr7/DO.png





C 120,50,70
F 22,150,90














1111111111111111111111111
1000000000110000000000001
1011000001110000000000001
100P10000000000000000000111111111
111111111011000001110000000000001
1000000000110000011010111111111111
111101111111110111000000000001
111101111111110111010100000001
110000001101010111000000000001111111
1000000000000000DD0000000000011000011111111111111111
10000000000000001101010000000D00W0000000001111111111111111
1100000111010101111101111000111000011111111111111111
11110111 1110101 1011110100011111111
11111111 1111111 111111111111
