


NO      ./graphic/NO.xpm




SO ./graphic/SO.xpm




WE ./graphic/WE.xpm



EA ./graphic/EA.xpm



DO ./graphic/DO.xpm





F 220,100,0
C 225,30,0















11111111111111111111111111
11111111111111111111000001
1111111111111110001S1001111111111111111111
111111111111100000111000000000011111000011
111111111111111111111111111111111111111111
