


NO      ./graphic/NO.png

C 225,30,0



SO ./graphic/SO.png
















EA ./graphic/EA.png

WE ./graphic/WE.png

DO ./graphic/DO.png




F 220,100,0








1111111111111111111111111
1000000000110000000000001
1011000001110000000000001
100100000000000000000000111111111
111111111011000001110000000000001
100000000011000001110111111111111
111101111111110111000000100001
111101111111110111010100100001
110000001101010111000000D00001
1000100000W00000DD00000010000111111111111111
10000000000000001101010010000000000000000001
11000001110101011111011110001111111111111111
11110111 1110101 101111010001
11111111 1111111 111111111111
