


NO      ./graphic/pack_cr7/NO.png




SO ./graphic/pack_cr7/SO.png




WE ./graphic/pack_cr7/WE.png



EA ./graphic/pack_cr7/EA.png






F 120,120,90
C 220,150,90








111111111111
1PPP0000PPP1
1PP000000PP1
1PP00E000PP1
1PP000000PP1
1PPP0000PPP1
111111111111
