


NO      ./graphic/pack_wolfenstein/bluestone.png




SO ./graphic/pack_wolfenstein/colorstone.png




WE ./graphic/pack_wolfenstein/greystone.png



EA ./graphic/pack_wolfenstein/mossy.png


DO ./graphic/pack_wolfenstein/barrel.png

F 220,100,0
C 225,30,0

1111111111111111111111111
0000000000110000000000001
1011000001110000000000001
100100000000000000000000111111111
111111111011000001110000000000001
10000000001100000111011000000111111
11110111111111011100000011011
11110111111111011101010010001
11000000110101011100000010001
100000000000000011000000100011
100000000000000011010100100001
11000001110101011111011110N001
11110111 1110101 101111010001
11111111 1111111 111111111111
