NO ./graphic/pack_piza_pise/NO.png
SO ./graphic/pack_piza_pise/SO.png
WE ./graphic/pack_piza_pise/EA.png
EA ./graphic/pack_piza_pise/WE.png
DO ./graphic/pack_piza_pise/DO.png
F 120,120,90
C 220,150,90

1111111111111
1000000000001
1000000000001
1110000000001
1010000000001
1011100000011
101000001111
101000001111
101000001111
1WD000001111
101000000111
101000000001
111111111001
1000000000011
1000000000011
1000000000011
1111111111111
