


NO      ./graphic/pack_wolfenstein/bluestone.png




SO ./graphic/pack_wolfenstein/colorstone.png




WE ./graphic/pack_wolfenstein/greystone.png



EA ./graphic/pack_wolfenstein/mossy.png


DO ./graphic/pack_wolfenstein/barrel.png




F                                                   22,22,12
C           20,22,70





1111111111111111111111111
1000000000110000000000001
1011000001110000000000001
10010000000000000000000011111111
111111111011000001110000000000001
100000000011000001110111111111111
11110111111111011100000010001
1111011111111101110101011111111
11000000110101011100000010001
1000000000000000110000010101
100000000000000011010100D0001
11000001110101111111011111N1111
11110111 1110101 101111011111
11111111 1111111 111111111111
