


NO      ./graphic/NO.png




SO ./graphic/SO.png




WE ./graphic/WE.png



EA ./graphic/EA.png



DO ./graphic/DO.png




F                                                   22,22,12
C           20,22,70





1111111111111111111111111
1000000000110000000000001
1011000001110000000000001
1001000000000000000000001
111111111011000001110000000000001
100000000011000001110111111111111
11110111111111011100000010001
11110111111111011101010
11000000110101011100000010001
1000000000000000110000010101
10000000000000001101010011001
11000001110101111111011111N1111
11110111 1110101 101111011111
11111111 1111111 111111111111
