NO      ./graphic/NO.xpm
SO      ./graphic/SO.xpm
WE      ./graphic/WE.xpm
EA      ./graphic/EA.xpm
DO      ./graphic/DO.xpm

F 178,69,171
C 247,204,196

1111111111111111111111111111111111111111111111111111111111111111111
1111111111111111111111111111111111111111111111111111111111111111111
1111111111111111111111111111111111111111111111111111111111111111111
1111111111111111111111111111111111111111111111111111111111111111111
1111111100001111111111111111111111111111111111111111111111111111111
1111111100001111111111111111111111111111111111111111111111111111111
1111111100001111111111111111111111111111111111111111111111111111111
1111111100001111111111111111111111111111111111111111111111111111111
1111111100000000000000000000000000000000000000011111111111111111111
1111111100001111111111111111111111111111111111011111111111111111111
1111111100001111111111111111111111111111111111011111111111111111111
1111111100001111111111111111111111111111111111011111111111111111111
1111111100001111111111111111111111111111111111011111111111111111111
1111111110111111111111111111111111111111111111011111111111111111111
1111111110111111111111111111111111111111111111011111111111111111111
1111111110111111111111111111111111111111111111011111111111111111111
1111111110111111111111111111111111111111111111011111111111111111111
1111111110111111111111111111111111111111111111011111111111111111111
1111111110111111111111111111111111111111111111011111111111111111111
1111111110111111111111111111111111111111111111011111111111111111111
1111111110111111111111111111111111111111111111011111111111111111111
1111111110111111111111111111111111111111111111011111111111111111111
1111111110111111111111111111111111111111111111011111111111111111111
1111111110111111111111111111111111111111111111011111111111111111111
1111111110111111111111111111111111111111111111011111111111111111111
1111111110111111111111111111111111111111111111011111111111111111111
1111111110111111111111111111111111111111111111011111111111111111111
1111111110111111111111111111111111111111111111011111111111111111111
1111111110111111111111111111111111111111111111011111111111111111111
1111111110111111111111111111111111111111111111011111111111111111111
1111111110111111111111111111111111111111111111011111111111111111111
1111111110111111111111111111111111111111111111011111111111111111111
1111111110111111111111111111111111111111111111011111111111111111111
1111111110111111111111111111111111111111111111011111111111111111111
1111111110111111111111111111111111111111111111011111111111111111111
1111111110111111111111111111111111111111111111011111111111111111111
1111111110111111111111111111111111111111111111011111111111111111111
1111111110111111111111111111111111111111111111011111111111111111111
1111111110111111111111111111111111111111111111011111111111111111111
1111111110111111111111111111111111111111111111011111111111111111111
1111111110111111111111111111111111111111111111011111111111111111111
1111111110111111111111111111111111111111111111011111111111111111111
1111111110111111111111111111111111111111111111011111111111111111111
1111111110111111111111111111111111111111111111011111111111111111111
1111111110111111111111111111111111111111111111011111111111111111111
1111111110111111111111111111111111111111111111011111111111111111111
1111111110111111111111111111111111111111111111011111111111111111111
1111111110111111111111111111111111111111111111011111111111111111111
1111111110111111111111111111111111111111111111011111111111111111111
1111111110111111111111111111111111111111111111011111111111111111111
1111111110111111111111111111111111111111111111011111111111111111111
1111111110111111111111111111111111111111111111011111111111111111111
1111111110111111111111111111111111111111111111011111111111111111111
1111111110111111111111111111111111111111111111011111111111111111111
1111111110111111111111111111111111111111111111011111111111111111111
1111111110111111111111111111111111111111111111011111111111110000111
1111111110111111111111111111111111111111111111011111111111110000111
1111111110111111111111111111111111111111111111011111111111110000111
1111111110111111111111111111111111111111111111011111111111110D00111
1111111110111111111111111111111111111111111111011111111111110000111
1111111110111111111111111111111111111111111111011111111111110000111
1111111110111111111111111111111111111111111111011111111111110000111
1111111110111111111111111111111111111111111111011111111111111011111
1111111110111111111111111111111111111111111111011111111111111011111
1111111110111111111111111111111111111111111111011111111111111011111
1111111110111111111111111111111111111111111111011111111111111011111
1111111110111111111111111111111111111111111111011111111111111011111
1111111110111111111111111111111111111111111111011111111111111011111
1111111110111111111111111111111111111111111111011111111111111011111
1111111110111111111111111111111111111111111111011111111111111011111
1111111110111111111111111111111111111111100000000001111111111011111
1111111110111111111111111111111111111111100000000001111111111011111
1111111110111111111111111111111111111111100000000001111111111011111
1111111110111111111111111111111111111111100000000001111111111011111
1111111100000000111000000000000000000000000000000001111111111011111
1111111100000000111011111111111111111111100000000001111111111011111
1111111100000000111011111111111111111111100000000001111111111011111
1111111100000000000000000000000000000000000000000000000000000011111
1111111100000000111011111111111111111111100000000001111111111111111
1111111100000000111011111111111111111111111110011111111111111111111
1111111100000000111011111111111111111111111110011111111111111111111
1111111110101111111011111111111111111111111110011111111111111111111
1111111110101111111011111111111111111111111110011111111111111111111
1111111110101111111011111111111111111111111110011111111111111111111
1111111110101111111011111111111111111111111110011111111111111111111
1111111110101111111011111111111111111111111110011111111111111111111
1111111110101111111011111111111111111111111110011111111111111111111
1111111110101111111011111111111111111111111110011111111111111111111
1111111110101111111011111111111111111111111110011111111111111111111
1111111110101111111011111111111111111111111110011111111111111111111
1111111110101111111011111111111111111111111110011111111111111111111
1111111110101111111011111111111111111111111110011111111111111111111
1111111110101111111011111111111111111111111110011111111111111111111
1111111110101111111011111111111111111111111110011111111111111111111
1111111110101111111011111111111111111111111110011111111111111111111
1111111110101111111011111111111111111111111110011111111111111111111
1111111110101111111011111111111111111111111110011111111111111111111
1111111110101111111011111111111111111111111110011111111111111111111
1111111110101111111011111111111111111111111110011111111111111111111
1111111110101111111011111111111111111111111110011111111111111111111
1111111110101111111011111111111111111111111110011111111111111111111
1111111110101111111011111111111111111111111110011111111111111111111
1111111110101111111011111111111111111111111110011111111111111111111
1111111110101111111011111111111111111111111100000011111111111111111
1111111110101111111011111111111111111111111100000011111111111111111
1111111110101111111011111111111111111111111100000011111111111111111
1111111110101111111011111111111111111111111100000011111111111111111
1111111110101111111011111111000000000000000000000011111111111111111
1111111110101111111011111111011111111111111100000011111111111111111
1111111110101111111011111111011111111111111100000011111111111111111
1111111110101111111011111111011111111111111100000011111111111111111
1111111110101111111011111111011111111111111100000011111111111111111
1111111110101111111011111111011111111111111110111111111111111111111
1111111110101111111011111111011111111111111110111111111111111111111
1111111110101111111011111111011111111111111110111111111111111111111
1111111110101111111011111111011111111111111110111111111111111111111
1111111110101111111011111111011111111111111110111111111111111111111
1111111110101111111011111111011111111111111110111111111111111111111
1111111110101111111011111111011111111111111110111111111111111111111
1111111110101111111011111111011111111111111110111111111111111111111
1111111110101111111011111111011111111111111110111111111111111111111
1111111110101111111011111111011111111111111110111111111111111111111
1111111110101111111011111111111111111111111110111111111111111111111
1111111110101111111011111111011111111111111110111111111111111111111
1111111110101111111011111111011111111111111110111111111111111111111
1111111110101111111011111111011111111111111110111111111111111111111
1111111110101111111011111111011111111111111110111111111111111111111
1111111110101111111011111111011111111111111110111111111111111111111
1111111110101111111011111111011111111111111110111111111111111111111
1111111110101111111011111111011111111111111110111111111111111111111
1111111110101111111011111111011111111111111110111111111111111111111
1111111110101111111011111111011111111111111110111111111111111111111
1111111110101111111011111111011111111111111110111111111111111111111
1111111110101111111011111111011111111111111110111111111111111111111
1111111110101111111011111111011111111111111110111111111111111111111
1111111110101111111011111111011111111111111110111111111111111111111
1111111110111111111000000000011111111111111110111111111111111111111
1111111110101111111000000000011111111111111110111111111111111111111
1111111110101111111000000000011111111111111110111111111111111111111
1111111110101111111000000000011111111111111110111111111111111111111
11111111101011111110000S0000000010000000000000111111111111111111111
1111111110101111111000000000011111111111111111111111111111111111111
1111111110101111111000000000011111111111111111111111111111111111111
1111111110101111111000000000011111111111111111111111111111111111111
1111111110101111111000000000011111111111111111111111111111111111111
1111111110101111111011111111011111111111111111111111111111111111111
1111111110101111111011111111011111111111111111111111111111111111111
1111111110101111111011111111011111111111111111111111111111111111111
1111111110101111111011111111011111111111111111111111111111111111111
1111111110101111111011111111011111111111111111111111111111111111111
1111111110101111111011111111011111111111111111111111111111111111111
1111111110101111111011111111011111111111111111111111111111111111111
1111111110101111111011111111011111111111111111111111111111111111111
1111111110101111111011111111011111111111111111111111111111111111111
1111111110101111111011111111011111111111111111111111111111111111111
1111111110101111111011111111011111111111111111111111111111111111111
1111111110101111111011111111011111111111111111111111111111111111111
1111111110101111111011111111011111111111111111111111111111111111111
1111111110101111111011111111011111111111111111111111111111111111111
1111111110101111111011111111011111111111111111111111111111111111111
1111111110101111111011111111011111111111111111111111111111111111111
1111111110101111111011111111011111111111111111111111111111111111111
1111111110101111111011111111011111111111111111111111111111111111111
1111111110101111111011111111011111111111111111111111111111111111111
1111111110101111111011111111011111111111111111111111111111111111111
1111111110101111111011111111011111111111111111111111111111111111111
1111111110101111111011111111011111111111111111111111111111111111111
1111111110101111111011111111011111111111111111111111111111111111111
1111111110101111000000011111011111111111111111111111111111111111111
1111111110101111000000011111011111111111111111111111111111111111111
1111111110000000000000011111011111111111111111111111111111111111111
1111111111101111000000011111011111111111111111111111111111111111111
1111111111101111000000011111011111111111111111111111111111111111111
1111111111101111000000011111011111111111111111111111111111111111111
1111111111101111111111111110000111111111111111111111111111111111111
1111111111100000000000000000000111111111111111111111111111111111111
1111111111111111111111111110000111111111111111111111111111111111111
1111111111111111111111111110000111111111111111111111111111111111111
1111111111111111111111111111111111111111111111111111111111111111111
1111111111111111111111111111111111111111111111111111111111111111111
1111111111111111111111111111111111111111111111111111111111111111111
1111111111111111111111111111111111111111111111111111111111111111111
1111111111111111111111111111111111111111111111111111111111111111111
1111111111111111111111111111111111111111111111111111111111111111111
1111111111111111111111111111111111111111111111111111111111111111111
1111111111111111111111111111111111111111111111111111111111111111111
1111111111111111111111111111111111111111111111111111111111111111111
1111111111111111111111111111111111111111111111111111111111111111111
1111111111111111111111111111111111111111111111111111111111111111111
1111111111111111111111111111111111111111111111111111111111111111111
1111111111111111111111111111111111111111111111111111111111111111111
1111111111111111111111111111111111111111111111111111111111111111111
1111111111111111111111111111111111111111111111111111111111111111111
1111111111111111111111111111111111111111111111111111111111111111111
1111111111111111111111111111111111111111111111111111111111111111111
1111111111111111111111111111111111111111111111111111111111111111111
1111111111111111111111111111111111111111111111111111111111111111111
1111111111111111111111111111111111111111111111111111111111111111111
