NO      ./graphic/NO.xpm
SO      ./graphic/SO.xpm
WE      ./graphic/WE.xpm
EA      ./graphic/EA.xpm
DO      ./graphic/DO.xpm

F 132,152,162
C 211,167,239

       1111111111            
      10000000000111111111   
      100000000000000000001  
      1000000000000000000011 
      10000000000000000000001
      10000000000000000000001
      10000000000000000000001
      10000000000111111000001
       1100000111     1000001
        100000111111111000001
        100000000000000000001
        100000000000000000001
        100000000000000000001
         11000000000000000001
          1000000000000000001
           111111111100000001
            10000000000000001
            10000000000000001
            10000000000000001
            10000000000000001
            10000000000000001
            10000000000000001
             1110000011000001
               10000000000001
               10000000000001
               10000000000001
               10000000000001
               10000000000001
               10000000000001
               10000000000001
               10000000000001
               10000000000001
               10000000000001
               10000000000001
               10000000000001
        111111110000000000001
       1000000000000000000001
      11000000000000000000001
     100000000000000000000001
     100000000000000000000001
     100000000000000000000001
     100000111110000000000001
     1000001   10000000000001
     1000001   10000000000001
     1000001   10000000000001
     1000001   10000000000001
     1000001   10000000000001
     1000001   10000000000001
     1000001   10000000000001
     1000001   10000000000001
     1000001   10000000000001
     1000001   10000000000001
     1000001   10000000000001
     1000001   10000000000001
     1000001   10000000000001
     1000001   10000000000001
     1000001   10000000000001
     1000001   10000000000001
     1000001   10000000000001
     1000001   10000000000001
     1000001   10000000000001
     1000001   10000000000001
     1000001   10000000000001
     1000001   10000000000001
     1000001   10000000000001
     1000001   10000000000001
     1000001   10000000000001
     1000001   10000000000001
     1000001   10000000000001
     1000001   10000000000001
     1000001   10000000000001
     1000001   10000000000001
     1000001   10000000000001
     1000001   10000000000001
     1000001   10000000000001
     1000001   10000000000001
     1000001   10000000000001
     1000001   10000000000001
     1000001   10000000000001
     1000001   10000000000001
     1000001   10000000000001
     1000001   10000000000001
     1000001   10000000000001
     1000001   10000000000001
     1000001   10000000000001
     1000001   10000000000001
     1000001   10000000000001
     1000001   10000000000001
     1000001   10000000000001
     1000001   10000000000001
     1000001   10000000000001
     1000001   10000000000001
     1000001   10000000000001
     1000001   10000000000001
     1000001   10000000000001
     1000001   10000000000001
     1000001   10000000000001
     1000001   10000000000001
     1000001   10000000000001
     1000001   10000000000001
     1000001   10000000000001
     1000001   10000000000001
     1000001   10000000000001
     1000001   10000000000001
     1000001   10000000000001
    100000001  10000000000001
    100000001  10000000000001
    100000001  10000000000001
    100000001  10000000000001
    1000D0001  10000000000001
    100000001  10000000000001
    100000001  10000000000001
    100000001  10000000000001
    100000001  10000000000001
     1111111   10000000000001
               10000000000001
               10000000000001
      11111111110000000000001
     100000000000000000000001
     100000000000000000000001
     10S000000000000000000001
     100000000000001000000001
     100000000000001000000001
      11111111111111000000001
                   1000000001
                   1000000001
                   1000000001
                   1000000001
                   1000000001
                   1000000001
                   1000000001
                   1000000001
                   1000000001
                   1000000001
                   1000000001
                   1000000001
                   1000000001
                    110000001
                     10000001
                      111111 
                             
                             
                             
                             
                             
                             
