NO      ./graphic/NO.xpm
SO      ./graphic/SO.xpm
WE      ./graphic/WE.xpm
EA      ./graphic/EA.xpm
DO      ./graphic/DO.xpm

F 100,123,94
C 227,194,129

11111111111111111111111111111111111111111111111111111111111111111111111111111111111111111111111111111111111111111111111111111111111111111111111111111111111111
11111111111111111111111111111111111111111111111111111111111111111111111111111111111111111111110000000000111111111111111111111111111111111111111111111111111111
11111111111111111111111111111111111111111111111111111111000000011111111111111111111111111111110000000000111111111111111111111111111111111111111111111111111111
11111111111111111111111111111111111111111111111111111111000000011111111111111111111111111111110000010000111111111111111111111111111111111111111111111111111111
11111111111111111111111111111111111111111111111111111111000000011111111111111100000000000000000000W00000111111111111111111111111111111111111111111111111111111
11111111111111111111111111111111111111111111111111111111000000000000000000000000000000000000010000000000111111111111111111111111111111111111111111111111111111
11111111111111111111111111111111111111111111111111111111000000011111111111111000011111111111010000000000111111111111111111111111111111111111111111111111111111
11111111111111111111111111111111111111111111111111111111000000011111111111111000011111111100000000000000111111111111111111111111111111111111111111111111111111
11111111111111111111111111111111111111111111111111111111000000011111111111111000011111111100000011111111111111111111111111111111111111111111111111111111111111
11111111111111111111111111111111111111111111111111111111111000000000000000000000011111111100000011111111111111111111111111111111111111111111111111111111111111
11111111111111111111111111111111111111111111111111111111111111111111111111000000000011111100000000000000000000000011111111111111111111111111111111111111111111
11111111111111111111111111111111111111111111111111111111111111111111111111000000000011111100000011111111111111111011111111111111111111111111111111111111111111
11111111111111111111111111111111111111111111111111111111000000000001111111000000000011111100000011111111111100000000000111111111111111111111111111111111111111
11111111111111111111111111100000000000010000000000000000000010000000000000000000000011111100000011111111111100000000000111111111111111111111111111111111111111
11111111111111111111111111101111111111111111111111111111000000000001111111000000000011111100000011111111111100000000000111111111111111111111111111111111111111
1111111111111111111111111110111111111111111111111111111100000D001001111111000000000000010000000000000000000000000000000111111111111111111111111111111111111111
11111111111111111111111111111111111111111111111111111111000000010001111111000000000011111111111111111111111100000000000111111111111111111111111111111111111111
11111111111111111111110000000000011111111111111111111111000000000001111111111111111111111111111111111111111100000000000111111111111111111111111111111111111111
11111111111111111111110000000000011111111111111111111111000000000001111111111111111111111111111111111111111100000000000111111111111111111111111111111111111111
11111111111111111111110000000000000000000000000000000000000000111111111111111111111111111111111111111111111111111111111111111111111111111111111111111111111111
11111111111111111111110000000000011111111111111111111111111111111111111111111111111111111111111111111111111111111111111111111111111111111111111111111111111111
11111111111111111111110000000000011111111111111111111111111111111111111111111111111111111111111111111111111111111111111111111111111111111111111111111111111111
11111111111111111111111111111111111111111111111111111111111111111111111111111111111111111111111111111111111111111111111111111111111111111111111111111111111111
11111111111111111111111111111111111111111111111111111111111111111111111111111111111111111111111111111111111111111111111111111111111111111111111111111111111111
11111111111111111111111111111111111111111111111111111111111111111111111111111111111111111111111111111111111111111111111111111111111111111111111111111111111111
11111111111111111111111111111111111111111111111111111111111111111111111111111111111111111111111111111111111111111111111111111111111111111111111111111111111111
11111111111111111111111111111111111111111111111111111111111111111111111111111111111111111111111111111111111111111111111111111111111111111111111111111111111111
11111111111111111111111111111111111111111111111111111111111111111111111111111111111111111111111111111111111111111111111111111111111111111111111111111111111111
11111111111111111111111111111111111111111111111111111111111111111111111111111111111111111111111111111111111111111111111111111111111111111111111111111111111111
