NO      ./graphic/NO.xpm
SO      ./graphic/SO.xpm
WE      ./graphic/WE.xpm
EA      ./graphic/EA.xpm
DO      ./graphic/DO.xpm

F 164,78,71
C 179,231,251

                                                     
           11111111111111111111111111111111111       
          1000000000000000000000000000000000001      
          10000000000000000000000000000000000011     
          100000000000000000000000000000000000001    
          100000000000000000000000000000000000001    
          100000000000000000000000000000000000001    
          100000111111100000000000000001111000001    
          1000001   1000000000000N000001  1000001    
          1000001   10000000000000000001  1000001    
          1000001   10000000000000000001  1000001    
          1000001   10000011000000000001  1000001    
          1000001   1000001 11111111111   1000001    
          1000001   1000001               1000001    
          1000001   1000001               1000001    
          1000001   1000001               1000001    
          1000001   1000001               1000001    
          1000001   1000001               1000001    
          1000001   1000001               1000001    
          1000001   1000001               1000001    
          1000001   1000001               1000001    
          1000001   1000001               1000001    
          1000001   1000001               1000001    
          1000001   1000001               1000001    
          1000001   1000001               1000001    
          1000001   1000001               1000001    
          1000001   1000001               1000001    
          1000001   1000001               1000001    
          1000001   1000001               1000001    
          1000001   1000001               1000001    
          1000001   1000001               1000001    
          1000001   1000001               1000001    
          1000001   1000001               1000001    
          1000001   1000001               1000001    
          1000001   1000001               1000001    
          1000001   1000001               1000001    
          1000001   1000001               1000001    
          1000001   1000001               1000001    
          1000001   1000001               1000001    
          1000001   1000001               1000001    
          1000001   1000001               1000001    
          1000001   1000001               1000001    
          1000001   1000001               1000001    
          1000001   1000001  11111        1000001    
          1000001   1000001 1000001       1000001    
          1000001   1000001 100D001       1000001    
          1000001   1000001 1000001       1000001    
          1000001   1000001 1000001       1000001    
          1000001   1000001 1000001       1000001    
          1000001   1000001 1000001       1000001    
          1000001   1000001 1000001       1000001    
          1000001   1000001 1000001       1000001    
          1000001   1000001 1000001       1000001    
          1000001   1000001 1000001       1000001    
          1000001   1000001 1000001       1000001    
          1000001   1000001 1000001       1000001    
          1000001   1000001 1000001       1000001    
          1000001   1000001 1000001       1000001    
          1000001   1000001 1000001       1000001    
     111111000001111100000111000001111111100000001   
    1000000000000000000000000000000000000000000001   
   11000000000000000000000000000000000000000000001   
  100000000000000000000000000000000000000000000001   
  100000000000000000000000000000000000000000000001   
  100000000000000000000000000000000000000000000001   
  100000111000000000000000000000000000000000000001   
  1000001 1000000011100000111000001111111100000001   
  1000001 100000001 1000001 1000001       11000001   
  1000001 100000001 1000001 1000001        1000001   
  1000001 100000001 1000001 1000001        1000001   
  1000001 100000001 1000001 1000001        1000001   
  1000001 100000001 1000001 1000001        1000001   
  1000001 100000001 1000001 1000001        1000001   
  1000001 100000001 1000001 1000001        1000001   
  1000001 100000001 1000001 1000001        1000001   
  1000001 100000001 1000001 1000001        1000001   
  1000001 100000001 1000001 1000001        1000001   
  1000001 100000001 1000001 1000001        1000001   
  1000001 100000001 1000001 1000001        1000001   
  1000001 100000001 1000001 1000001        1000001   
  1000001 100000001 1000001 1000001        1000001   
  1000001 100000001 1000001 1000001        1000001   
  1000001 100000001 1000001 1000001        1000001   
  1000001 100000001 1000001 1000001        1000001   
  1000001 10000000111000001 1000001        1000001   
  1000001 10000000000000001 1000001        1000001   
  1000001 10000000000000001 1000001        1000001   
  1000001 10000000000000001 1000001        1000001   
  1000001 10000000000000001 1000001        1000001   
  1000001  1111111111000001 1000001        1000001   
  1000001           1000001 1000001        1000001   
  1000001           1000001 1000001        1000001   
  1000001           100000111000001        1000001   
  1000001          1000000001000001111111111000001   
  1000001          1000000000000000000000000000001   
  1000001          1000000000000000000000000000001   
  1000001          1000000000000000000000000000001   
  1000001          100000000000000000000000000011    
  1000001          10000000000000000000000000001     
  1000001          1000000001000001111111111111      
  1000001           111111111000001                  
  1000001                   1000001                  
  1000001                   1000001                  
  1000001                   1000001                  
  1000001                   1000001                  
  1000001                   1000001                  
  1000001                   1000001                  
  1000001                   1000001                  
  1000001                   1000001                  
  1000001                   1000001                  
  1000001                   1000001                  
  1000001                   1000001                  
  1000001                   1000001                  
  1000001                   1000001                  
  1000001                   1000001                  
  1000001                   1000001                  
  1000001                   1000001                  
  1000001                   1000001                  
  100000111111111111111111111000001                  
 1000000000000000000000000000000001                  
 1000000000000000000000000000000001                  
 1000000000000000000000000000000001                  
 100000000000000000000000000000011                   
 10000000000000000000000000000001                    
  111111111111111111111111111111                     
                                                     
                                                     
                                                     
                                                     
                                                     
                                                     
                                                     
                                                     
                                                     
                                                     
                                                     
                                                     
                                                     
                                                     
                                                     
                                                     
                                                     
                                                     
                                                     
                                                     
                                                     
                                                     
                                                     
                                                     
                                                     
                                                     
                                                     
                                                     
                                                     
                                                     
                                                     
                                                     
                                                     
                                                     
                                                     
                                                     
                                                     
                                                     
                                                     
                                                     
                                                     
                                                     
                                                     
                                                     
                                                     
                                                     
                                                     
                                                     
                                                     
                                                     
                                                     
                                                     
                                                     
                                                     
                                                     
                                                     
                                                     
                                                     
                                                     
                                                     
                                                     
                                                     
                                                     
                                                     
                                                     
                                                     
