NO      ./graphic/NO.xpm
SO      ./graphic/SO.xpm
WE      ./graphic/WE.xpm
EA      ./graphic/EA.xpm
DO      ./graphic/DO.xpm

F 102,128,133
C 212,159,138

                                                                                                               
                                                                                                               
                                                                                                               
                                                                                                               
                                                       11111111                                                
                                                      1000000001                                               
                                                      100000000111111111111                                    
                                                      1000000000000000000001                                   
                                                      10000000000000000000011                                  
                                                      100000000000000000000001                                 
                                                      100000000000000000000001                                 
                                                      100000000000000000000001                                 
                                                      100000000111111111000001                                 
                                                      1000000001       1000001                                 
                                                       10000011        1000001                                 
                                                       1000001         1000001                                 
                                                       1000001         1000001                                 
                                                       1000001         1000001                                 
                                                       1000001         1000001                                 
                                                       1000001         1000001                                 
                                                       1000001         1000001                                 
                                                       1000001         1000001                                 
                                                       1000001         1000001                                 
                                                       1000001         10000011111                             
                                                       1000001         1000000000011111                        
                                                       1000001         10000000000000001                       
                                                       1000001         100000000000000011                      
                                                       1000001         100000E000000000001                     
                                                       1000001         1000000000000000001                     
                                                       1000001         1000000000000000001                     
                                                       1000001         1000000000011000001                     
                                                       1000001         10000011111 1000001                     
                                                       1000001         1000001     1000001                     
                                                       1000001         1000001     1000001                     
                                                       1000001         1000001     1000001                     
                                                       1000001         1000001     1000001                     
                                                       1000001         1000001     1000001                     
   11111111                                            1000001         1000001     1000001                     
  1000000001                                           1000001         1000001     1000001                     
  1000000001                                           1000001         1000001     1000001                     
  1000000001                                           1000001         1000001     1000001                     
  1000D00001                                           1000001         1000001     1000001                     
  1000000001                                           1000001         1000001     1000001                     
  1000000001                                           1000001         1000001     1000001                     
  1000000001                                           1000001         1000001     1000001                     
   10000011                                            1000001         1000001     1000001                     
   1000001                                             10000011111111111000001111111000001                     
   1000001                                             10000000000000000000000000000000001                     
   1000001                                             10000000000000000000000000000000001                     
   1000001                                             10000000000000000000000000000000001                     
   1000001                                              1100000000000000000000000000000001                     
   1000001                                               100000000000000000000000000000001                     
   1000001                                                11111111111111000001111111100001                     
   1000001                                                             1000001      100001                     
   1000001                                                             1000001       1111                      
   1000001                                                             1000001                                 
   1000001                                                             1000001                                 
   1000001                                                             1000001                                 
   1000001                                                             1000001                                 
   1000001                                                             1000001                                 
   1000001                                                             1000001                                 
   1000001                                                             1000001                                 
   1000001                                                             1000001                                 
   1000001                                                             1000001                                 
   1000001                                                             1000001                                 
   1000001                                                             1000001        11111                    
   1000001                            111111111111111111111111111111111100000111111111000001                   
   1000001                           1000000000000000000000000000000000000000000000000000001                   
   1000001                          11000000000000000000000000000000000000000000000000000001                   
   1000001                         100000000000000000000000000000000000000000000000000000001                   
   1000001                         100000000000000000000000000000000000000000000000000000001                   
   1000001                         100000000000000000000000000000000000000000000000000000001                   
   1000001                         100000111111111111111111111111111111100000111111111000001                   
   1000001                         1000001                             1000001       1000001                   
   1000001                         1000001                             1000001       1000001                   
   1000001                         1000001                             1000001       1000001                   
   1000001                         1000001                             1000001       1000001                   
   1000001                         1000001                             1000001       1000001                   
   1000001                         1000001                             1000001       1000001                   
   1000001                         1000001                             1000001       1000001                   
   1000001                         1000001                             1000001       1000001                   
   1000001                         1000001                             1000001       1000001                   
   1000001                         1000001                             1000001       1000001                   
   1000001                         1000001                             1000001       1000001                   
   1000001                         1000001                             1000001       1000001                   
   1000001                         1000001                             1000001       1000001                   
   1000001                         1000001                             1000001       1000001                   
   1000001                         1000001                             1000001       1000001                   
   1000001                         1000001                             1000001       1000001                   
   1000001                         1000001                             1000001       1000001                   
   1000001                         1000001                             1000001       1000001                   
   1000001                         1000001                             1000001       1000001                   
   1000001                         1000001                             1000001       1000001                   
   1000001                         1000001                             1000001       1000001                   
   1000001                         1000001                             1000001       1000001                   
   1000001                         10000011                            1000001       1000001                   
   10000011111111111111111111111111000000001                           1000001       1000001                   
   10000010000000000000000000000000000000001                           1000001       1000001                   
   10000010000000000000000000000000000000001                           1000001       1000001                   
   10000000000000000000000000000000000000001                           1000001       1000001                   
   10000000000000000000000000000000000000001                           1000001       1000001                   
   10000000000000000000000000000000000000001                           1000001       1000001                   
   10000000001111111111111111111111000000001                           1000001       1000001                   
   10000000001                     11111111                            1000001       1000001                   
   10000000001                                                         1000001       1000001                   
   10000000001                                                         1000001       1000001                   
   10000000001                                                         1000001       1000001                   
   10000000001                                                         1000001       1000001                   
   10000000001                                                         1000001       1000001                   
   10000000001                                                         1000001       1000001                   
   10000000001                                                         1000001       1000001                   
   10000000001                                                         1000001       1000001                   
   10000000001                                                         1000001       1000001                   
   10000000001                                                         1000001       1000001                   
   10000000001                                                         1000001       1000001                   
   10000000001                                                         1000001       1000001                   
   10000000001                                                         1000001       1000001                   
   10000000001                                                         1000001       1000001                   
   10000000001                                                         1000001       1000001                   
   10000000001                                                        110000011      1000001                   
   10000000001                                                       10000000001     1000001                   
   10000000001                                                       10000000001111111000001                   
   10000000001                                                       10000000000000000000001                   
   10000000001                                                       10000000000000000000001                   
   10000000001                                                       10000000000000000000001                   
   10000000001                                                       1000000000000000000011                    
   10000000001                                                       100000000000000000001                     
   10000000001                                                       10000000001111111111                      
   10000000001                                                       10000000001                               
   10000000001                                                        111111111                                
   10000000001                                                                                                 
   10000000001                                                                                                 
   10000000001                                                                                                 
   10000000001                                                                                                 
   10000000001                                                                                                 
   10000000001                                                                                                 
   10000000001                                                                                                 
   10000000001                                                                                                 
   10000000001                                                                                                 
   10000000001                                                                                                 
   10000000001                                                                                                 
   100000000001                                                                                                
   100000000001                                                                                                
   100000000001                                                                                                
   100000000001                                                                                                
    11000000001                                                                                                
     1000000001                                                                                                
      100000001                                                                                                
       1111111                                                                                                 
                                                                                                               
                                                                                                               
                                                                                                               
                                                                                                               
                                                                                                               
                                                                                                               
                                                                                                               
                                                                                                               
                                                                                                               
                                                                                                               
                                                                                                               
                                                                                                               
                                                                                                               
                                                                                                               
                                                                                                               
                                                                                                               
                                                                                                               
                                                                                                               
                                                                                                               
                                                                                                               
                                                                                                               
                                                                                                               
                                                                                                               
                                                                                                               
                                                                                                               
                                                                                                               
                                                                                                               
                                                                                                               
                                                                                                               
                                                                                                               
                                                                                                               
