NO      ./graphic/NO.xpm
SO      ./graphic/SO.xpm
WE      ./graphic/WE.xpm
EA      ./graphic/EA.xpm
DO      ./graphic/DO.xpm

F 110,167,82
C 216,152,176

11111111111111111111111111111111111111111111111111111111111111111
11111111111111111111111111111111111111111111111111111111111111111
11111111111111111111111111111111111111111111111111111111111111111
11111111111111111111111111111111111111111111111111111111111111111
11111111111111111111111111111111111111111111111111111111111111111
11111111111111111111111111111111111111111111111111111111111111111
11111111111111111111111111111111111111111111111111111111111111111
11111111111111111111111111111111111111111111111111111111111111111
11111111111111111111111111111111111111111111111111111111111111111
11111111111111111111111111111111111111111111111111111111111111111
11111111111111111111111111111111111111111111111111111111111111111
11111111111111111111111111111111111111111111111111111111111111111
11111111111111111111111111111111111111111111111111111111111111111
11111111111111111111111111111111111111111111111111111111111111111
11111111111111111111111111111111111111111111111111111111111111111
11111111111111111111111111111111111111111111111111111111111111111
11111111111111111111111111111111111111111111111111111111111111111
11111111111111111111111111111111111111111111111111111111111111111
11111111111111111111111111111111111111111111111111111111111111111
11111111111111111111111111111111111111111111111111111111111111111
11111111111111111111111111111111111111111111111111111111111111111
11111111111111111111111111111111111111111111111111111111111111111
11111111111111111111111111111111111111111111111111111111111111111
11111111111111111111111111111111111111111111111111111111111111111
11111111111111111111111111111111111111111111111111111111111111111
11111111111111111111111111111111111111111111111111111111111111111
11111111111111111111111111111111111111111111111111111111111111111
11111111111111111111111111111100000001111111111111111111111111111
11111111111111111111111111111100000001111111111111111111111111111
11111111111111111111111111111100000001111111111111111100000111111
11111111111111111111111111111100000000000000000000000000000111111
11111111111111111111111111111100000001111111111111111100000111111
11111111111111000000000000000000000000000000000000000000000111111
11111111111111011111111111111100000001111101111111111100000111111
11111111111111011111111111111100000001111101111111111100000111111
11111111111111011111111111111100000001111101111111111100000111111
11111111111111011111111111111100000001111101111111111111111111111
11111111111111011111111111111111101111111101111111111111111111111
11111111111000000011111111111111101111111101111111111111111111111
11111111111000000011111111111111101111111101111111111111111111111
11111111111000000011111111111111101111111101111111111111111111111
11111111111000000011111111111111101111111101111111111111111111111
11111111111000000000000000000000001111111101111111111111111111111
11111111111000000011111111111111101111111101111111111111111111111
11111111111000000011111111111111101111111101111111111111111111111
11111111111000000011111111111111101111111101111111111111111111111
11111111111000000011111111111111101111111101111111111111111111111
11111111111111111111111111111111101111111101111111111111111111111
11111111111111111111111111111111101111111101111111111111111111111
11111111111111111111111111111111101111111101111111111111111111111
11111111111111111111111111111111101111111101111111111111111111111
11111111111111111111111111111111101111111101111111111111111111111
11111111111111111111111111111111101111111101111111111111111111111
11111111111111111111111111111111101111111101111111111111111111111
11111111111111111111111111111111101111111101111111111111111111111
11111111111111111111111111111111101111111101111111111111111111111
11111111111111111111111111111111101111111101111111111111111111111
11111111111111111111111111111111101111111101111111111111111111111
11111111111111111111111111111111101111111101111111111111111111111
11111111111111111111111111111111101111111101111111111111111111111
11111111111111111111111111111111101111111101111111111111111111111
11111111111111111111111111111111101111111101111111111111111111111
11111111111111111111111111111111101111111101111111111111111111111
11111111111111111111111111111111101111111101111111111111111111111
11111111111111111111111111111111101111111101111111111111111111111
11111111111111111111111111111111101111111101111111111111111111111
11111111111111111111111111111111101111111101111111111111111111111
11111111111111111111111111111111101111111101111111111111111111111
11111111111111111111111111111111101111111101111111111111111111111
11111111111111111111111111111111101111111101111111111111111111111
11111111111111111111111111111111101111111101111111111111111111111
11111111111111111111111111111111101111111101111111111111111111111
11111111111111111111111111111111101111111101111111111111111111111
11111111111111111111111111111111101111111101111111111111111111111
11111111111111111111111111111111101111111101111111111111111111111
11111111111111111111111111111111101111111101111111111111111111111
11111111111111111111111111111111101111110000011111111111111111111
11111111111111111111111111111111101111100000000011111111111111111
11111111111000001111111111111111101111100000000011111111111111111
1111111111100D000000000000000000000000000000000011111111111111111
11111111111000001111111111111111111111100000000011111111111111111
11111111111000001111111111111111111111100000000011111111111111111
11111111111111111111111111111111111111100000000011111111111111111
11111111111111111111111111111111111111111110111111111111111111111
11111111111111111111111111111111111111111110111111111111111111111
11111111111111111111111111111111111111111110111111111111111111111
11111111111111111111111111111111111111111110111111111111111111111
11111111111111111111111111111111111111111110111111111111111111111
11111111111111111111111111111111111111111110111111111111111111111
11111111111111111111111111111111111111111110111111111111111111111
11111111111111111111111111111111111111111110111111111111111111111
11111111111111111111111111111111111111111110111111111111111111111
11111111111111111111111111111111111111111110111111111111111111111
11111111111111111111111111111111111111111110111111111111111111111
11111111111111111111111111111111111111111110111111111111111111111
11111111111111111111111111111111111111111110111111111111111111111
11111111111111111111111111111111111111111110111111111111111111111
11111111111111111111111111111111111111111110111111111111111111111
11111111111111111111111111111111111111111110111111111111111111111
11111111111111111111111111111111111111111110111111111111111111111
11111111111111111111111111111111111111111110111111111111111111111
11111111111111111111111111111111111111111110111111111111111111111
11111111111111111111111111111111111111111110111111111111111111111
11111111111111111111111111111111111111111110111111111111111111111
11111111111111111111111111111111111111111110111111111111111111111
11111111111111111111111111111111111111111110111111111111111111111
11111111111111111111111111111111111111111110111111111111111111111
11111111111111111111111111111111111111111110111111111111111111111
11111111111111111111111111111111111111111110111111111111111111111
11111111111111111111111111111111111111111110111111111111111111111
11111111111111111111111111111111111111111110111111111111111111111
11111111111111111111111111111111111111111110111111111111111111111
11111111111111111111111111111111111111111110111111111111111111111
11111111111111111111111111111111111111111110111111111111111111111
11111111111111111111111111111111111111111110111111111111111111111
11111111111111111111111111111111111111111110111111111111111111111
11110000001111111111111111111111111111111110111111111111111111111
11110000001111111111111111111111111111111110111111111111111111111
111100S0000000000000000000000000000000000000111111111111111111111
11110000001111111111111111111111111111111111111111111111111111111
11110000001111111111111111111111111111111111111111111111111111111
11111111111111111111111111111111111111111111111111111111111111111
11111111111111111111111111111111111111111111111111111111111111111
11111111111111111111111111111111111111111111111111111111111111111
11111111111111111111111111111111111111111111111111111111111111111
11111111111111111111111111111111111111111111111111111111111111111
11111111111111111111111111111111111111111111111111111111111111111
11111111111111111111111111111111111111111111111111111111111111111
11111111111111111111111111111111111111111111111111111111111111111
11111111111111111111111111111111111111111111111111111111111111111
11111111111111111111111111111111111111111111111111111111111111111
11111111111111111111111111111111111111111111111111111111111111111
11111111111111111111111111111111111111111111111111111111111111111
11111111111111111111111111111111111111111111111111111111111111111
