NO      ./graphic/NO.xpm
SO      ./graphic/SO.xpm
WE      ./graphic/WE.xpm
EA      ./graphic/EA.xpm
DO      ./graphic/DO.xpm

F 136,156,191
C 210,168,199

                                                                                                                     
                                                                                                                     
                                                                                                                     
                                                                                                                     
                                                                         1111111111111111111111111111111111111111    
                                 1111111                                100000000000000000000000000000000000000001   
                                100000001                               1000000000000000000000000000000000000000011  
                       111111111100000001                               10000000000000000000000000000000000000000001 
                      1000000000000000001                               10000000000000000000000000000000000000000001 
                     11000000000000000001                               10000000000000000000000000000000000000000001 
                    100000000000000000001                               10000001111111111111111111111111111111000001 
                    100000000000000000001                               1000001                              1000001 
                    100000000000000000001                               1000001                              1000001 
                    100000111111100000001                               1000001                              1000001 
                    1000001     100000001                               1000001                              1000001 
                    10000011111111000001111111111111111111111           1000001                              1000001 
                   110000000000000000000000000000000000000000111111111111000001                              1000001 
                  10000000000000000000000000000000000000000000000000000000000001                             1000001 
                  10000000000000000000000000000000000000000000000000000000000001                             1000001 
                  10000000000000000000000000000000000000000000000000000000000001                             1000001 
                  10000000000000000000000000000000000000000000000000000000000001                            100000001
                   1111111111111110000000000000000000000000000000000000000000001                            1000D0001
                                 10000011111111111111111110000011111111110000001                            100000001
                                 1000001                 1000001        10000001                            100000001
                                 1000001                 1000001        10000001                             1111111 
                                 1000001                 1000001        10000001                                     
                                 1000001                 1000001        10000001                                     
                                 1000001                 1000001        10000001                                     
                                 1000001                 1000001        10000001                                     
                                 1000001                 1000001        10000001                                     
                                 1000001                 1000001        10000001                                     
                                 1000001                 1000001        10000001                                     
                                 1000001                 1000001        10000001                                     
                                 1000001                 1000001        10000001                                     
                                 1000001                 1000001        10000001                                     
                                 1000001                 1000001        10000001                                     
                                 1000001                 1000001        10000001                                     
                                 1000001                 1000001        10000001                                     
                                 1000001                 1000001        10000001                                     
                                 1000001                 1000001        10000001                                     
                                 1000001                 1000001        10000001                                     
                                 1000001                 1000001        10000001                                     
                                 10000011111111111111111110000011111111110000001                                     
                                 10000000000000000000000000000000000000000000001                                     
                                100000000000000000000000000000000000000000000001                                     
                                100000000000000000000000000000000000000000000001                                     
                                100000000000000000000000000000000000000000000001                                     
                                100000000000000000000000000000000000000000000001                                     
                                 10000011111111111111111000000000000000000000001                                     
                                 1000001               100000000000000000000011                                      
                                 1000001               10000000000000000000001                                       
                                 1000001               1000000000011111111111                                        
                                 1000001               100000000001                                                  
                                 1000001                1111111111                                                   
                                 1000001                                                                             
                                 1000001                                                                             
                                 1000001                                                                             
                                 1000001                                                                             
                                 1000001                                                       111111                
                                 100000111111111111111111111111111111111111111111111111111111110000001               
                                 100000000000000000000000000000000000000000000000000000000000000000001               
                                 100000000000000000000000000000000000000000000000000000000000000000001               
                                 1000000000000000000000000000000000000000000000000000000000000000N0001               
                                  11000000000000000000000000000000000000000000000000000000000000000001               
                                   1000000000000000000000000000000000000000000000000000000000000000001               
                                    111111111111111111111111111111111111111111111111111111111110000001               
                                                                                              10000001               
                                                                                               111111                
                                                                                                                     
                                                                                                                     
                                                                                                                     
                                                                                                                     
                                                                                                                     
                                                                                                                     
                                                                                                                     
                                                                                                                     
                                                                                                                     
                                                                                                                     
                                                                                                                     
                                                                                                                     
