NO      ./graphic/NO.xpm
SO      ./graphic/SO.xpm
WE      ./graphic/WE.xpm
EA      ./graphic/EA.xpm
DO      ./graphic/DO.xpm

F 134,158,143
C 152,139,175

1111111111111111111111111111111111111111111111111111111111111
1111111111111111111111111111111111111111111111111111111111111
1111111111111111111111111111111111111111111111111111111111111
1111111111111111111111111111111111111111111111111111111111111
1111111111111111111111111111111111111111111111111111111111111
1111111111111111111111111111111111111111111111111111111111111
1111111111111111111111111111111111111111111111111111111111111
1111111111111111111111111111111111111111111111111111111111111
1111111111111111111111111111111111111111111111111111111111111
1111111111111111111111111111111111111111111111000000111111111
1111111111111111111111111111111111111111111111000000111111111
1111111111111111111111111111111111111111111111000000111111111
1111111111111111111111111111111111111111111111000000111111111
1111111111111111111111111111111111111111111111000000111111111
1111111111111111111111111111111111111111111111000000111111111
1111111111111111111111111111111111111111111111100111111111111
1111111111111111111111111111111111111111111111100111111111111
1111111111111111111111111111111111111111111111100111111111111
1111111111111111111111111111111111111111111111100111111111111
1111111111111111111111111111111111111111111111100111111111111
1111111111111111111111111111111111111111111111100111111111111
1111111111111111111111111111111111111111111111100111111111111
1111111111111111111111111111111111111111111111100111111111111
1111111111111111111111111111111111111111111111100111111111111
1111111111111111111111111111111111111111111111100111111111111
1111111111111111111111111111111111111111111111100111111111111
1111111111111111111111111111111111111111111111100111111111111
1111111111111111111111111111111111111111111111100111111111111
1111111111111111111111111111111111111111111111100111111111111
1111111111111111111111111111111111111111111111100111111111111
1111111111111111111111111111111111111111111111100111111111111
1111111111111111111111111111111111111111111111100111111111111
1111111111111111111111111111111111111111111111100111111111111
1111111111111111111111111111111111111111111111100111111111111
1111111111111111111111111111111111111111111111100111111111111
1111111111111111111111111111111111111111111111100111111111111
1111111111111111111111111111111111111111111111100111111111111
1111111111111111111111111111111111111111111111100111111111111
1111111111111111111111111111111111111111111111100111111111111
1111111111111111111111111111111111111111111111100111111111111
1111111111111111111111111111111111111111111111100111111111111
1111111111111111111111111111111111111111111111100111111111111
1111111111111111111111111111111111111111111100000001111111111
1111111111111111111111111111111111111111111100000001111111111
11111111111111111111111111111111111111111111000D0001111111111
1111111111111111111111111111111111111111111100000001111111111
1111111111111111111111111111111111111111111100000001111111111
1111111111111111111111111111111111111111111100000001111111111
1111111111111111111111111111111111111111111111110111111111111
1111111111111111111111111100000000001111111111110111111111111
1111111111111111111111111100000000001111111111110111111111111
1111111111111100000000001100000000000000000000000011111111111
1111111111111100000100001100000000001111111111110011111111111
111111111111110000W000001100000000001111111111110011111111111
1111111111111100000000001111110111111111111111110011111111111
1111111111111100000000001111110111111111111111110011111111111
1111111111111111111111011111110111111111111111110011111111111
1111111111111111111111011111110111111111111111110011111111111
1111111111111111111111011111110111111111111111110011111111111
1111111111111111111111011111110111111111111111110011111111111
1111111111111111111111011111110111111111111111110011111111111
1111111111111111111111011111110111111111111111110011111111111
1111111111111111111111011111110111111111111111110011111111111
1111111111111111111111011111110111111111111111110011111111111
1111111111111111111111011111110111111111111111110011111111111
1111111111111111111111011111110111111111111111110011111111111
1111111111111111111111011111110111111111111111110011111111111
1111111111111111111111011111110111111111111111110011111111111
1111111111111111111111011111110111111111111111110011111111111
1111111111111111111111011111110111111111111111110011111111111
1111111111111111111111011111110111111111111111110011111111111
1111111111111111111111011111110111111111111111110011111111111
1111111111111111111111011111110111111111111111110011111111111
1111111111111111111111011111110111111111111111110011111111111
1111111111111111111111011111110111111111111111110011111111111
1111111111111111111111011111110111111111111111110011111111111
1111111111111111111111011111110111111111111111110011111111111
1111111111111111111111011111110111111111111111110011111111111
1111111111111111111111011111110111111111111111110011111111111
1111111111111111111111011111110111111111111111110011111111111
1111111111111111111111011111110111111111111111110011111111111
1111111111111111111111011111110111111111111111110011111111111
1111111111111111100000000000110111111111111111110011111111111
1111111111111111100000000000110111111111111111110011111111111
1111111111111111100000000000000000111111111111110011111111111
1111111111111111100000000000110110111111111111110011111111111
1111111111111110000000000000110110111111111111110011111111111
1111111111111110000111111111110110111111111111110011111111111
1111111111111110000111111111110110111111111111110011111111111
1111111111111110000000000000000110111111111111110011111111111
1111111111111110000111111111111110111111111111110011111111111
1111111111111110000111111111111110111111111111110011111111111
1111111111111110001111111111111110111111111111110011111111111
1111111111111110000111111111111110111111111111110011111111111
1111111111111111011111111111111110111111111111110011111111111
1111111111111111011111111111111110111111111111110011111111111
1111111111111111011111111111111110111111111111110011111111111
1111111111111111011111111111111110111111111111110011111111111
1111111111111111011111111111111110111111111111110011111111111
1111111111111111011111111111111110111111111111110011111111111
1111111111111111011111111111111110111111111111110011111111111
1111111111111111011111111111111110111111111111110011111111111
1111111111111111011111111111111110111111111111110011111111111
1111111111111111011111111111111110111111111111110011111111111
1111111111111111011111111111111110111111111111110011111111111
1111111111111111011111111111111110111111111111110011111111111
1111111111111111011111111111111110111111111111110011111111111
1111111111111111011111111111111110111111111111110011111111111
1111111111111111011111111111111110111111111111110011111111111
1111111111111111011111111111111110111111111111100000011111111
1111111111111111011111111111110000000111111111100000011111111
1111111111111111011111111111110000000111111111100000011111111
1111111111111111011111111111110000000111111111100000011111111
1111111111111111000000000000000000000111111111100000011111111
1111111111111111111111111111110000000111111111100000011111111
1111111111111111111111111111110000000111111111111111111111111
1111111111111111111111111111110000000111111111111111111111111
1111111111111111111111111111110000000111111111111111111111111
1111111111111111111111111111111111111111111111111111111111111
1111111111111111111111111111111111111111111111111111111111111
1111111111111111111111111111111111111111111111111111111111111
1111111111111111111111111111111111111111111111111111111111111
1111111111111111111111111111111111111111111111111111111111111
1111111111111111111111111111111111111111111111111111111111111
1111111111111111111111111111111111111111111111111111111111111
1111111111111111111111111111111111111111111111111111111111111
1111111111111111111111111111111111111111111111111111111111111
1111111111111111111111111111111111111111111111111111111111111
1111111111111111111111111111111111111111111111111111111111111
