NO      ./graphic/NO.xpm
SO      ./graphic/SO.xpm
WE      ./graphic/WE.xpm
EA      ./graphic/EA.xpm
DO      ./graphic/DO.xpm

F 80,68,137
C 200,199,176

11111111111111111111111111111111111111111111111111111111111111111111111111
11111111111111111111111111111111111111111111111111111111111111111111111111
11111111111111111111111111111111111111111111111111111111111111111111111111
11111111111111111111111111111111111111111111111111111111111111111111111111
11111111111111111111111111111111111111111111111111111111111111111111111111
11111111111111111111111111111111111111111111111111111111111111111111111111
11111111111111111111111111111111111111111111111111111111111111111111111111
11111111111111111111111111111111111111111111111111111111111111111111111111
11111111111111111111111111111111111111111111111111111111111111111111111111
11111111111111111111111111111111111111111111111111111111111111111111111111
11111111111111111111111111111111111111111111111111111111111111111111111111
11111111110000000011111111111111111111111111111111111111111111111111111111
11111111110000000000000000000100000000001111111111111111111111111111111111
11111111110000000011111111111111111111101111111111111111111111111111111111
11111111110000000011111111111111111111101111111111111111111111111111111111
11111111111110111111111111111111111111101111111111111111111111111111111111
11111111111110111111111111111111111111101111111111111111111111111111111111
11111111111110111111111111111111111111101111111111111111111111111111111111
11111111111110111111111111111111111111101111111111111111111111111111111111
11111111111110111111111111111111111111101111111111111111111111111111111111
11111111111110111111111111111111111111101111111111111111111111111111111111
11111111111110111111111111111111111111101111111111111111111111111111111111
11111111111110111111111111111111111111101111111111111111111111111111111111
11111111111110111111111100000000111111101111111111111111111111111111111111
11111111111110111111111000000000111111101111111111111111111111111111111111
11111111111110111111111000000000111111101111111111111111111111111111111111
11111111111110111111111000000000000000000000000000000000000000000111111111
11111111111110111111111000000000111111101111111111111111111111110111111111
11111111111110111111111000000000111111101111111111111111111111110111111111
11111111111110111111111000000000111111101111111111111111111111110111111111
11111111111110111111111000000000111111101111111111111111111111110111111111
11111111111110111111111111101111111111101111111111111111111111110111111111
11111111111110111111111111101111111111101111111111111111111111110111111111
11111111111110111111111111101111111111101111111111111111111111110111111111
11111111111110111111111111101111111111101111111111111111111111110111111111
11111111111110111111111111101111111111101111111111111111111111110111111111
11111111111110111111111111101111111111101111111111111111111111110111111111
11111111111110111111111111100001111111101111111111111111111111110111111111
1111111111111011111111111110W000000000000000000000000000000000010111111111
11111111111110111111111111100001111111101111111111111111111111010111111111
11111111111110111111111111100001111111101111111111111111111111010111111111
11111111111110111111111111101111111111101111111111111111111111010111111111
11111111111110111111111111101111111111101111111111111111111111010111111111
11111111111110111111111111101111111111101111111111111111111111010111111111
11111111111110111111111111101111111111101111111111111111111111010111111111
11111111111110111111111111101111111111101111111111111111111111010111111111
11111111111110111111111111101111111111101111111111111111111111010111111111
11111111111110111111111111101111111111101111111111111111111111010111111111
11111111111110111111111111101111111111101111111111111111111111010111111111
11111111111110111111111111101111111111101111111111111111111111010111111111
11111111111110111111111111101111111111101111111111111111111111010111111111
11111111111110111111111111101111111111101111111111111111111111010111111111
11111111111110111111111111101111111111101111111111111111111111010111111111
11111111111110111111111111101111111111101111111111111111111111010111111111
11111111111110111111111111101111111111101111111111111111111000000000011111
11111111111110000000000000000000000000000000000000000000000000000000011111
11111111111111111111111111101111111111101111111111111111111000000000011111
11111111111111111111111111101111111111101111111111111111111000000000011111
11111111111111111111111111100000000000000000000000000000000000000001111111
11111111111111111111111111111111111111101111111111111111111000000001111111
11111111111111111111111111111111111111101111111111111111111000010001111111
11111111111111111111111111111111111111101111111111111111111000000001111111
11111111111111111111111111111111111111101111111111111111111000000001111111
11111111111111111111111111111111111111101111111111111111111111111111111111
11111111111111111111111111111111111111101111111111111111111111111111111111
11111111111111111111111111111111111111101111111111111111111111111111111111
11111111111111111111111111111111111111101111111111111111111111111111111111
11111111111111111111111111111111111111101111111111111111111111111111111111
11111111111111111111111111111111111111101111111111111111111111111111111111
11111111111111111111111111111111111111101111111111111111111111111111111111
11111111111111111111111111111111111111101111111111111111111111111111111111
11111111111111111111111111111111111111101111111111111111111111111111111111
11111111111111111111111111111111111111101111111111111111111111111111111111
11111111111111111111111111111111111111101111111111111111111111111111111111
11111111111111111111111111111111111111101111111111111111111111111111111111
11111111111111111111111111111111111111101111111111111111111111111111111111
11111111111111111111111111111111111111101111111111111111111111111111111111
11111111111111111111111111111111111111101111111111111111111111111111111111
11111111111111111111111111111111111111101111111111111111111111111111111111
11111111111111111111111111111111111111101111111111111111111111111111111111
11111111111111111111111111111111111111101111111111111111111111111111111111
11111111111111111111111111111111111111101111111111111111111111111111111111
11111111111111111111111111111111111111101111111111111111111111111111111111
11111111111111111111111111111111111111101111111111111111111111111111111111
11111111111111111111111111111111111111101111111111111111111111111111111111
11111111111111111111111111111111111111101111111111111111111111111111111111
11111111111111111111111111111111111111101111111111111111111111111111111111
11111111111111111111111111111111111111101111111111111111111111111111111111
11111111111111111111111111111111111111101111111111111111111111111111111111
11111111111111111111111111111111111111101111111111111111111111111111111111
11111111111111111111111111111111111111101111111111111111111111111111111111
11111111111111111111111111111111111111101111111111111111111111111111111111
11111111111111111111111111111111111111101111111111111111111111111111111111
11111111111111111111111111111111111111101111111111111111111111111111111111
11111111111111111111111111111111111111101111111111111111111111111111111111
11111111111111111111111111111111111111101111111111111111111111111111111111
11111111111111111111111111111111111111101111111111111111111111111111111111
11111111111111000000000011111111111111101111111111111111111111111111111111
11111111111111000000000011111111111111101111111111111111111111111111111111
11111111111111000000000000000000000000101111111111111111111111111111111111
11111111111111000000000011111111111110101111111111111111111111111111111111
11111111111111000000000011111111111110101111111111111111111111111111111111
11111111111111111101111111111111111110101111111111111111111111111111111111
11111111111111111101111111111111111110101111111111111111111111111111111111
11111111111111111101111111111111111110101111111111111111111111111111111111
11111111111111111101111111111111111110101111111111111111111111111111111111
11111111111111111101111111111111111110101111111111111111111111111111111111
11111111111111111101111111111111111110101111111111111111111111111111111111
11111111111111111101111111111111111110101111111111111111111111111111111111
11111111111111111101111111111111111110101111111111111111111111111111111111
11111111111111111101111111111111111000000111111111111111111111111111111111
11111111111111111101111111111111111000000111111111111111111111111111111111
11111111111111111101111111111111111000000111111111111111111111111111111111
1111111111111111110111111111111111100D000111111111111111111111111111111111
11111111111111111101111111111111111000000001111111111111111111111111111111
11111111111111111101111111111111111000000001111111111111111111111111111111
11111111111111111101111111111111111000000001111111111111111111111111111111
11111111111111111101111111111111111110000001111111111111111111111111111111
11111111111111111100000000000000000000000001111111111111111111111111111111
11111111111111111111111111111111111110000001111111111111111111111111111111
11111111111111111111111111111111111110000001111111111111111111111111111111
11111111111111111111111111111111111110000001111111111111111111111111111111
11111111111111111111111111111111111110000001111111111111111111111111111111
11111111111111111111111111111111111111111111111111111111111111111111111111
11111111111111111111111111111111111111111111111111111111111111111111111111
11111111111111111111111111111111111111111111111111111111111111111111111111
11111111111111111111111111111111111111111111111111111111111111111111111111
11111111111111111111111111111111111111111111111111111111111111111111111111
11111111111111111111111111111111111111111111111111111111111111111111111111
11111111111111111111111111111111111111111111111111111111111111111111111111
11111111111111111111111111111111111111111111111111111111111111111111111111
11111111111111111111111111111111111111111111111111111111111111111111111111
