NO      ./graphic/NO.xpm
SO      ./graphic/SO.xpm
WE      ./graphic/WE.xpm
EA      ./graphic/EA.xpm
DO      ./graphic/DO.xpm

F 183,123,98
C 181,254,244

                                                                                                          
                                                                                                          
                                                                                                          
                                                                                                          
                                                                                                          
                                                                                                          
                                                                                                          
                                                                                                          
                                                                                                          
                                                                                                          
                                                                                                          
                                                                                                          
                                                                                                          
                                                                                                          
                                                                                                          
                                                                                                          
                                                                                                          
                                                                                                          
                                                                                                          
                                                                                                          
                                                                                                          
                                                                                                          
                                                                                                          
                                                                                                          
                                                                                                          
                                                                                                          
                                                                                                          
                                                                                                          
                                                                                                          
                                                                                                          
                                                                                                          
                                                                                                          
                                                                                                          
                                                                                                          
                                                                                                          
                                                                                                          
                                                                                                          
                                                                                                          
                                                                                                          
                                                                                                          
                                                                                                          
                                                                                                          
                                                                                                          
                                                                                                          
                                                                                                          
                                                                                                          
                                                                                                          
                                                                                                          
                                                                                                          
                                                                                                          
                                                 1111                                                     
                                                100001111111111111111111111111111111111111111111111       
                                                1000000000000000000000000000000000000000000000000001      
                                                10000000000000000000000000000000000000000000000000011     
                                               1000000000000000000000000000000000000000000000000000001    
                                               1000000000000000000000000000000000000000000000000000001    
                                               1000000000000000000000000000000000000000000000000000001    
                                               1000001111111111111111111111111111111111111111111000001    
                                               1000001              111111111                  1000001    
                                               1000001             10000000001                 1000001    
                                               1000001             10000000001                 1000001    
                                               1000001             10000000001                 1000001    
                                               1000001             10000D00001                 1000001    
                                               1000001             10000000001                 1000001    
                                               1000001             10000000001                 1000001    
                                               1000001             10000000001                 1000001    
                                               1000001             10000000001                 1000001    
                                               1000001              110000011                  1000001    
                                               1000001               1000001                   1000001    
                                               1000001               1000001                   1000001    
                                               1000001               1000001                   1000001    
                                               1000001               1000001                   1000001    
                                               1000001               1000001                   1000001    
                                               1000001               1000001                   1000001    
                                               1000001               1000001                   1000001    
                                               1000001               1000001                   1000001    
                                               1000001               1000001                   1000001    
    11111                                      1000001               1000001                   1000001    
   10000011111111111111111111111111111111111111100000111111111111111110000011111111111111111   1000001    
   100000000000000000000000000000000000000000000000000000000000000000000000000000000000000001  1000001    
   100000000000000000000000000000000000000000000000000000000000000000000000000000000000000001111000001    
   100W00000000000000000000000000000000000000000000000000000000000000000000000000000000000000000000001    
   100000000000000000000000000000000000000000000000000000000000000000000000000000000000000000000000001    
   100000000000000000000000000000000000000000000000000000000000000000000000000000000000000000000000001    
   100000111111111111111111111111111111111111111000000000000000000000000000000000000000000000000000001    
    11111                                       110000000000000000000000000000000000000000000000000001    
                                                 10000000000000000000000000000000000000000000000000001    
                                                  1111111111111111111100000111111111111000000000000001    
                                                                     1000001           111111111000001    
                                                                     1000001                   1000001    
                                                                     1000001                   1000001    
                                                                     1000001                   1000001    
                                                                     1000001                   1000001    
                                                                     1000001                   1000001    
                                                                     1000001                   1000001    
                                                                     1000001                   1000001    
                                                                     1000001                   1000001    
                                                                     1000001                   1000001    
                                                                     1000001                   1000001    
                                                                     1000001                   1000001    
                                                                     1000001                   1000001    
                                                                     1000001                   1000001    
                                                                     1000001                   1000001    
                                                                     1000001                   1000001    
                                                                     1000001                   1000001    
                                                                     1000001                   1000001    
                                                                     1000001                   1000001    
                                                                     1000001                   1000001    
                                                                     1000001                   1000001    
                                                                     1000001                   1000001    
                                                                     1000001                   1000001    
                                                                     1000001                   1000001    
                                                                     1000001                   1000001    
                                                                     1000001                   1000001    
                                                                     1000001                   1000001    
                                                                     1000001                   1000001    
                                                                     1000001                   1000001    
                                                                     1000001                   1000001    
                                                                     1000001                   1000001    
                                                                     1000001                   1000001    
                                                                     1000001                   1000001    
                                                                     1000001                   1000001    
                                                                     1000001                   1000001    
                                                                     1000001                   1000001    
                                                                     1000001                   1000001    
                                                                  1111000001                   1000001    
                                                                 10000000001                   1000001    
                                                                 10000000001                   1000001    
                                                                 10000000001                   1000001    
                                                                 10000000001                   1000001    
                                                                 10000000001                   1000001    
                                                                 1000000011                    1000001    
                                                                 100000001                     1000001    
                                                                 10000001                      1000001    
                                                                 10000001                      1000001    
                                                                 1000001                       1000001    
                                                                 1000001                       1000001    
                                                                 1000001                       1000001    
                                                           11111110000011111111111111111111111110000011   
                                                          1000000000000000000000000000000000000000000001  
                                                         11000000000000000000000000000000000000000000001  
                                                        100000000000000000000000000000000000000000000001  
                                                        100000000000000000000000000000000000000000000001  
                                                        100000000000000000000000000000000000000000000001  
                                                        100000111100000111111111111111111111110000000001  
                                                        1000001  1000001                      111111111   
                                                        1000001  1000001                                  
                                                        1000001  1000001                                  
                                                        1000001  1000001                                  
                                                        1000001  1000001                                  
                                                        1000001  1000001                                  
                                                        1000001  1000001                                  
                                                        1000001  1000001                                  
                                                        1000001  1000001                                  
                                                        1000001  1000001                                  
                                                        1000001  1000001                                  
                                       11111111111      1000001  1000001                                  
                                      1000000000001111111000001111000001                                  
                                      1000000000000000000000000000000001                                  
                                      1000000000000000000000000000000001                                  
                                      1000000000000000000000000000000001                                  
                                      100000000000000000000000000000011                                   
                                      10000000000000000000000000000001                                    
                                      1000000000001111111000001111111                                     
                                      1000000000001     1000001                                           
                                       11100000111      1000001                                           
                                         1000001        1000001                                           
                                         1000001        1000001                                           
                                         1000001        1000001                                           
                                         1000001        1000001                                           
                                         1000001        1000001                                           
                                         1000001        1000001                                           
                                         100000111111111100000111                                         
                                         1000000000000000000000001                                        
                                         1000000000000000000000001                                        
                                         1000000000000000000000001                                        
                                          110000000000000000000001                                        
                                           10000000000000000000001                                        
                                            1111111111100000000001                                        
                                                       1111111111                                         
                                                                                                          
                                                                                                          
                                                                                                          
                                                                                                          
                                                                                                          
                                                                                                          
                                                                                                          
