NO      ./graphic/NO.xpm
SO      ./graphic/SO.xpm
WE      ./graphic/WE.xpm
EA      ./graphic/EA.xpm
DO      ./graphic/DO.xpm

F 140,176,155
C 157,236,155

                                                                
                                                                
                                                                
                                                                
                                                                
       111111                                                   
      10000001                                                  
      10000001                                                  
      100D0001                                                  
      10000001                                                  
      10000001                                                  
      1000001                                                   
      1000001                                                   
      1000001                                                   
      1000001                                                   
      1000001                                                   
      1000001                                                   
      1000001                                                   
      1000001                                                   
      1000001                                                   
      1000001                                                   
      1000001                                                   
      1000001                                                   
      1000001                                                   
      1000001                                                   
      1000001                                                   
      100000111111111111111111111111                            
     10000000000000000000000000000001                           
    110000000000000000000000000000001                           
   10000000000000000000000000000W0001                           
   1000000000000000000000000000000001                           
   1000000000000000000000000000000001                           
   100000000111111111000000001111111                            
   1000000001       1000000001                                  
   1000000001       100000001                                   
   1000000001       100000001                                   
   1000000001       100000001                                   
   1000000001       100000001                                   
   1000000001       100000001                                   
   1000000001       100000001                                   
   1000000001      100000000111111111111111                     
   1000000001      1000000000000000000000001                    
   1000000001      10000000000000000000000011                   
   1000000001      100000000000000000000000001                  
   1000000001      100000000000000000000000001                  
   1000000001      100000000000000000000000001                  
   1000000001      100000000111111111111000001                  
   1000000001       111000001          1000001                  
   1000000001         1000001          1000001                  
   1000000001         1000001          1000001                  
   1000000001         1000001          1000001                  
   1000000001         1000001          1000001                  
   1000000001         1000001          1000001                  
   1000000001         1000001          1000001                  
   1000000001         1000001          1000001                  
   1000000001         1000001          1000001                  
   1000000001         1000001          1000001                  
   1000000001         1000001          1000001                  
   1000000001         1000001          1000001                  
   1000000001         1000001          1000001                  
   1000000001         1000001          1000001                  
   1000000001         1000001          1000001                  
   1000000001         1000001          1000001                  
   1000000001         1000001          1000001                  
   1000000001         1000001          1000001                  
   1000000001         1000001          1000001                  
   1000000001         1000001          1000001                  
   1000000001         1000001          1000001                  
   1000000001         1000001         1100000111111             
   1000000001         1000001        100000000000001            
   1000000001         1000001        1000000000000011           
   1000000001         1000001        10000000000000001          
   1000000001         1000001        10000000000000001          
   1000000001         1000001        10000000000000001          
   1000000001         1000001         1111111111000001          
   1000000001         1000001                  1000001          
   1000000001         1000001                  1000001          
   1000000001         1000001                  1000001          
   1000000001         1000001                  1000001          
   1000000001         1000001                  1000001          
   1000000001         1000001                  1000001          
   1000000001         1000001                  1000001          
   1000000001         1000001                  1000001          
   1000000001         1000001                  1000001          
   1000000001         1000001                  1000001          
   1000000001         1000001                  1000001          
   1000000001         1000001                  1000001          
   1000000001         1000001                  1000001          
   1000000001         1000001                  1000001          
   1000000001         1000001                  1000001          
   1000000001         1000001                  1000001          
   1000000001         1000001                  1000001          
   1000000001         1000001                  1000001          
   1000000001         1000001                  1000001          
   1000000001         1000001                  1000001          
   100000000111111111110000011111111111111111111000001          
   1000000000000000000000000000000000000000000000000011         
   10000000000000000000000000000000000000000000000000001        
   10000000000000000000000000000000000000000000000000001        
   10000000000000000000000000000000000000000000000000001        
   10000000000000000000000000000000000000000000000000001        
   1000001111111111111100000111111111111111111111111111         
   1000001            1000001                                   
   1000001            1000001                                   
   1000001            1000001                                   
   1000001            1000001                                   
   1000001            1000001                                   
   1000001            1000001                                   
   1000001            1000001                                   
   1000001            1000001                                   
   1000001            1000001                                   
   1000001            1000001                                   
   1000001            1000001                                   
   1000001            1000001                                   
   1000001            1000001                                   
   1000001            1000001                                   
   1000001            1000001                                   
   1000001            1000001                                   
   1000001            1000001                                   
   1000001            1000001                                   
   1000001            1000001                                   
   1000001            1000001                                   
   1000001            1000001                                   
   1000001            1000001                                   
   1000001            1000001                                   
   1000001            1000001                                   
   1000001            1000001                                   
   1000001            1000001                                   
   1000001            1000001                                   
   1000001            1000001                                   
   1000001            1000001                                   
   1000001            1000001                                   
   1000001            1000001                                   
   1000001            1000001                                   
   1000001            1000001                                   
   1000001            1000001                                   
   1000001            1000001                                   
   1000001            1000001                                   
   1000001            1000001                                   
   1000001   1111111111000001                                   
   1000001  10000000000000001                                   
   1000001  10000000000000001                                   
   1000001  10000000000000001                                   
   1000001  1000000000000011                                    
   1000001  100000000000001                                     
   1000001  10000011111111                                      
   1000001  1000001                                             
   1000001  1000001                                             
   1000001  1000001                                             
   1000001  1000001                                             
   1000001  1000001                                             
   1000001  1000001                                             
   1000001  1000001                                             
   1000001  1000001                                             
   1000001111000001                                             
  11000000000000001                                             
 100000000000000001                                             
 100000000000000001                                             
 10000000000000011                                              
 1000000000000001                                               
  11111111111111                                                
                                                                
                                                                
                                                                
                                                                
                                                                
                                                                
                                                                
