NO      ./graphic/NO.xpm
SO      ./graphic/SO.xpm
WE      ./graphic/WE.xpm
EA      ./graphic/EA.xpm
DO      ./graphic/DO.xpm

F 137,64,191
C 238,138,178

11111111111111111111111111111111111111111111111111111111
11111111111111111111111111111111111111111111111111111111
11111111111111111111111111111111111111111111111111111111
11111111111111111111111111111111111111111111111111111111
11111111111111111111111111111111111111111111111111111111
11111111111111111111111111111111111111111111111111111111
11111111111111111111111111111111111111111111111111111111
11111111111111111111111111111111111111111111111111111111
11111111111111111111111111111111111111111111111111111111
11111111111111111111111111111111111111111111111111111111
11111111111111111111111111111111111111111111111111111111
11111111111111111111111111111111111111111111111111111111
11111111111111111111111111111111111111111111111111111111
11111111111111111111111111111111111111111111111111111111
11111111111111111111111111111111111111111111111111111111
11111111111111111111111111111111111111111111111111111111
11111111111111111111111111111111111111111111111111111111
11111111111111111111111111111111111111111111111111111111
11111111111111111111111111111111111111111111111111111111
11111111111111111111111111111111111111111111111111111111
11111111111111111111111111111111111111111111111111111111
11111111111111111111111111111111111111111111111111111111
11111111111111111111111111111111111111111111111111111111
11111111111111111111111111111111111111111111111111111111
11111111111111111111111111111111111111111111111111111111
11111111111111111111111111111111111111111111111111111111
11111111111111111111111111111111111111111111111111111111
11111111111111111111111111111111111111111111111111111111
11111111111111111111111111111111111111111111111111111111
11111111111111111111111111111111111111111111111111111111
11111111111111111111111111111111111111111111111111111111
11111111111111111111111111111111111111111111111111111111
11111111111111111111111111111111111111111111111111111111
11111111111111111111111111111111111111111111111111111111
11111110000000000111111111111111111111111111111111111111
11111110000000000111111111111111111111111111111111111111
11111110000000000111110000000001111111111111111111111111
11111110000000000111110000000001111111111111111111111111
11111110000000000000000000E00000000000000000111111111111
11111110000000000111110000000001111111111110111111111111
11111110000000000111110000000001111111111110111111111111
11111110000000000111111111101111111111111110111111111111
11111110000000000111111111101111111111111110111111111111
11111111111011111111111111101111111111111110111111111111
11111111111011111111111111101111111111111110111111111111
11111111111011111111111111101111111111111110111111111111
11111111111011111111111111101111111111111110111111111111
11111111111011111111111111101111111111111110111111111111
11111111111011111111111111101111111111111110111111111111
11111111111011111111111111101111111111111110111111111111
11111111111011111111111111101111111111111110111111111111
11111111111011111111111111101111111111111110111111111111
11111111111011111111111111101111111111111110111111111111
11111111111011111111111111101111111111111110111111111111
11111111111011111111111111101111111111111110111111111111
11111111111011111111111111101111111111111110111111111111
11111111111011111111111111101111111111111110111111111111
11111111111011111111111111101111111111111110111111111111
11111111111011111111111111101111111111111110111111111111
11111111111011111111111111101111111111111110111111111111
11111111111011111111111111101111111111111110111111111111
11111111111011111111111111101111111111111110111111111111
11111111111011111111111111101111111111111110111111111111
11111111111011111111111111101111111111111110111111111111
11111111111011111111111111101111111111111110111111111111
11111111111011111111111111101111111111111110111111111111
11111111111011111111111111101111111111111110111111111111
11111111100000000001111111101111111111111110111111111111
11111111100000000001111111101111111111111110111111111111
11111111100000000000000000000011111111111110111111111111
11111111100000000001111111101011111111111110111111111111
11111111100000000001111111101011111111111110111111111111
11111111100000000001111111101011111111111110111111111111
11111111111010111111111111101011111111111110111111111111
11111111111010111111111111101011111111111110111111111111
11111111111010111111111111101011111111111110111111111111
11111111111010111111111111101011111111111110111111111111
11111111111010111111111111101011111111111110111111111111
11111111111010111111111111101011111111111110111111111111
11111111111010111111000000001011111111111110111111111111
11111111111010111111000000001011111111111110111111111111
11111111111000000000000000001011111111111110111111111111
11111111111110111111000000001011111111111110111111111111
11111111111110111111000000001011111111111110111111111111
11111111111110111111111011101011111111111110111111111111
11111111111110111111111011101011111111111110111111111111
11111111111110111111111011101011111111111110111111111111
11111111111110111111111011101011111111111110111111111111
11111111111110111111111011101011111111111110111111111111
11111111111110111111111011101011111111100000000001111111
11111111111110111111111011101011111111100000000001111111
11111111111110111111111011101011111111100000000001111111
11111111111110000000000000000000000000000000000001111111
11111111111111111111111011101011111111100000000001111111
11111111111111111111111011101011111111100000000001111111
11111111111111111111111011101011111111100000000001111111
11111111111111111111111011101011111111100000000001111111
11111111111111111111111011101011111111111111111111111111
11111111111111111111111011101011111111111111111111111111
11111111111111111111111011101011111111111111111111111111
11111111111111111111111000000000111111111111111111111111
11111111111111111111111000000000111111111111111111111111
11111111111111111111111000000000111111111111111111111111
11111111111111111111111000000000000000000001111111111111
11111111111111111111111000000000111111111101111111111111
11111111111111111111111001000000111111111101111111111111
11111111111111111111111000000000111111111101111111111111
11111111111111111111111011111011111111111101111111111111
11111111111111111111111011111011111111111101111111111111
11111111111111111111111011111011111111111101111111111111
11111111111111111111111011111011111111000000000011111111
11111111111111111111111011111011111111000000000011111111
11111111111111111111111011111011111111000000000011111111
11111111111111111111111011111011111111000000000011111111
11111111111111111111111000000000000000000000000011111111
11111111111111111111111111111011111111000000000011111111
11111111111111111111111111111011111111000000000011111111
11111111111111111111111111111011111111000000000011111111
11111111111111111111111111111011111111000000000011111111
11111111111111111111111111111011111111111111111111111111
11111111111111111111111111111011111111111111111111111111
11111111111111111111111111111011111111111111111111111111
11111111111111111111111111111011111111111111111111111111
11111111111111111111111111111011111111111111111111111111
11111111111111111111111111111011111111111111111111111111
11111111111111111111111111111011111111111111111111111111
11111111111111111111111111111011111111111111111111111111
11111111111111111111111111111011111111111111111111111111
11111111111111111111111111111011111111111111111111111111
11111111111111111111111111111011111111111111111111111111
11111111111111111111111111111011111111111111111111111111
11111111111111111111111111111011111111111111111111111111
11111111111111111111111111111011111111111111111111111111
11111111111111111111111111111011111111111111111111111111
11111111111111111111111111111011111111111111111111111111
11111111111111111111111111111011111111111111111111111111
11111111111111111111111111111011111111111111111111111111
11111111111111111111111111111011111111111111111111111111
11111111111111111111111111111011111111111111111111111111
11111111111111111111111111111011111111111111111111111111
11111111111111111111111111111011111111111111111111111111
11111111111111111111111111111011111111111111111111111111
11111111111111111111111111100000111111111111111111111111
11111111111111111111111111100000111111111111111111111111
11111111111111111111111111100000111111111111111111111111
11111111111111111111111111100000111111111111111111111111
11111111111111111111111111100D00111111111111111111111111
11111111111111111111111111100000111111111111111111111111
11111111111111111111111111100000111111111111111111111111
11111111111111111111111111100000111111111111111111111111
11111111111111111111111111100000111111111111111111111111
11111111111111111111111111111111111111111111111111111111
11111111111111111111111111111111111111111111111111111111
11111111111111111111111111111111111111111111111111111111
11111111111111111111111111111111111111111111111111111111
11111111111111111111111111111111111111111111111111111111
11111111111111111111111111111111111111111111111111111111
11111111111111111111111111111111111111111111111111111111
11111111111111111111111111111111111111111111111111111111
11111111111111111111111111111111111111111111111111111111
11111111111111111111111111111111111111111111111111111111
11111111111111111111111111111111111111111111111111111111
11111111111111111111111111111111111111111111111111111111
11111111111111111111111111111111111111111111111111111111
11111111111111111111111111111111111111111111111111111111
11111111111111111111111111111111111111111111111111111111
11111111111111111111111111111111111111111111111111111111
