NO      ./graphic/NO.xpm
SO      ./graphic/SO.xpm
WE      ./graphic/WE.xpm
EA      ./graphic/EA.xpm
DO      ./graphic/DO.xpm

F 188,179,92
C 175,136,213

                                                                                        
                                                                                        
                                                                                        
                                                                                        
                                                                                        
                                                                                        
                                                                                        
                                                                                        
                                                                                        
                                                                                        
                                                                                        
                                                                                        
                                                                                        
                                                                                        
                                  1111111111                                            
   111111111111111111111111111111100000000001                                           
  1000000000000000000000000000000000000000001                                           
 11000000000000000000000000000000000000000001                                           
100000000000000000000000000000000000000000001                                           
100000000000000000000000000000000000000000001                                           
100000000000000000000000000000000000000000001                                           
100000111111111111111111111111111100000000001                                           
1000001                          100000000001                                           
1000001                           1100000111                                            
1000001                            1000001                                              
1000001                            1000001                                              
1000001                            1000001                                              
1000001                            1000001                                              
1000001                            1000001                                              
1000001                            1000001                                              
1000001                            1000001                                              
1000001                            1000001                                              
1000001                            1000001                                              
1000001                            1000001                                              
1000001                            1000001                                              
1000001                            1000001                                              
1000001                            1000001                                              
1000001                            1000001                                              
1000001                            1000001                                              
1000001                            1000001                                              
1000001                            1000001                                              
1000001                            1000001                                              
1000001                            1000001                                              
1000001                            1000001                                              
1000001                            1000001                                              
1000001                            1000001                                              
1000001                            1000001                           1111               
1000001                            100000111111111111111111111111111100001              
1000001                            100000000000000000000000000000000000001              
1000001                            100000000000000000000000000000000000001              
1000001                            100000000000000000000000000000000000001              
1000001                             11000000000000000000000000000000000001              
1000001                              1000000000000000000000000000000000001              
1000001                               111111111111111111111111111111000001              
1000001                                                            1000001              
1000001                                                            1000001              
1000001                                               11111111111  1000001              
1000001                                              100000000000111000001              
1000001                                              100000000000000000001              
1000001                                              100000000000000000001              
1000001                                              100000000000000000001              
1000001                                              10000000000000000011               
1000001                                              1000000000000000001                
1000001                                              100000000000111111                 
1000001                                               11100000111                       
1000001                                                 1000001                         
1000001111                                              1000001                         
10000000001                                             1000001                         
100000000011                                            1000001                         
1000000000001                                           1000001                         
 100000000001                                           1000001                         
 100000000001                                           1000001                         
 100001000001                                           1000001                         
  11111000001                                           1000001                         
      1000001                                           1000001                         
      1000001                                           1000001                         
      1000001                                           1000001                         
      1000001                                           1000001                         
      1000001                                           1000001                         
      1000001                                           1000001                         
      1000001                                           1000001                         
      1000001                                           1000001                         
      1000001                                           1000001                         
      1000001                                           1000001                         
      100000111111111111111111111111111111111111111     1000001                         
      1000000000000000000000000000000000000000000001    1000001                         
      10000000000000000000000000000000000000000000011   1000001                         
      100000000000000000000000000000000000000000000001  1000001                         
      100000000000000000000000000000000000000000000001  1000001                         
      100000000000000000000000000000000000000000000001  1000001                         
      100000111111111111111111111111111111111111000001  1000001                         
      1000001                                  1000001  1000001                         
       11111                                   1000001  1000001                         
                                               1000001  1000001                         
                                               1000001  1000001                         
                                               1000001  1000001                         
                                               1000001  1000001                         
                                               1000001  1000001                         
                                               1000001  1000001                         
                                               1000001  1000001                         
                                               1000001  1000001                         
                                               1000001  1000001                         
                                               1000001  1000001                         
                                               1000001  1000001                         
                                               1000001  1000001                         
                                               1000001  1000001              111111111  
                                               1000001  1000001             10000000001 
                                               1000001  1000001111111111111110000000001 
                                               1000001  1000000000000000000000000000001 
                                               1000001  1000000000000000000000000000001 
                                               1000001  1000000000000000000000000000001 
                                               1000001   110000000000000000000000000001 
                                               1000001    10000000000000000000000000001 
                                               1000001     1111111111111110E00000000001 
                                               1000001                   10000000000001 
                                             11100000111                 1000000001111  
                                            1000000000001                100001111      
                                            1000000000001                 1111          
                                            100000D000001                               
                                            1000000000001                               
                                            1000000000001                               
                                             11111111111                                
                                                                                        
                                                                                        
                                                                                        
                                                                                        
                                                                                        
                                                                                        
                                                                                        
                                                                                        
                                                                                        
                                                                                        
                                                                                        
                                                                                        
                                                                                        
                                                                                        
                                                                                        
                                                                                        
                                                                                        
                                                                                        
                                                                                        
                                                                                        
                                                                                        
                                                                                        
                                                                                        
                                                                                        
                                                                                        
                                                                                        
                                                                                        
