NO      ./graphic/NO.xpm
SO      ./graphic/SO.xpm
WE      ./graphic/WE.xpm
EA      ./graphic/EA.xpm
DO      ./graphic/DO.xpm

F 105,105,75
C 144,213,205

11111111111111111111111111111111111111111111111111111111111111111111111111111111111111111111111111111
11111111111111111111111111111111111111111111111111111111111111111111111111111111111111111111111111111
11111111111111111111111111111111111111111111111111111111111111111111111111111111111111111111111111111
11111111111111111111111111111111111111111111111111111111111111111111111111111111111111111111111111111
11111111111111111111111111111111111111111111111111111111111111111111111111111111111111111111111111111
11111111111111111111111111111111111111111111111111111111111111111111111111111111111111111111111111111
11111111111111111111111111111111111111111111111111111111111111111111111111111111111111111111111111111
11111111111111111111111111111111111111111111111111111111111111111111111111111111111111111111111111111
11111111111111111111111111111111111111111111111111111111111111111111111111111111111111111111111111111
11111111111111111111111111111111111111111111111111111111111111111111111111111111111111111111111111111
11111111111111111111111111111111111111111111111111111111111111111111111111111111111111111111111111111
11111111111111111111111111111111111111111111111111111111111111111111111111111111111111111111111111111
11111111111111111111111111111111111111111111111111111111111111111111111111111111111111111111111111111
11111111111111111111111111111111111111111111111111111111111111111111111111111111111111111111111111111
11111111111111111111111111111111111111111111111111111111111111111111111111111111111111111111111111111
11111111111111111111111111111111111111111111111111111111111111111111111111111111111111111111111111111
11111111111111111111111111111111111111111111111111111111111111111111111111111111111111111111111111111
11111111111111111111111111111111111111111111111111111111111111111111111111111111111111111111111111111
11111111111111111111111111111111111111111111111111111111111111111111111111111111111111111111111111111
11111111111111111111111111111111111111111111111111111111111111111111111111111111111111111111111111111
11111111111111111111111111111111111111111111111111111111111111111111111111111111111111111111111111111
11111111111111111111111111111111111111111111111111111111111111111111111111111111111110000000111111111
11111111111111111111111111111111111111111111111111111111111111111111111111111111111110000000111111111
1111111111111111111111111111111111111111111111111111111111111111111000000000000000000000N000111111111
11111111111111111111111111111111111111111111111111111111111111111110111111111111111110000000111111111
11111111111111111111111111111111100001111111111111111111111111111110111111111111111110000000111111111
11111111111111111111111111111111100001111111111111111111111111111110111111111111111111111111111111111
11111111111111111111111111111111100001111111111111111111111111111110111111111111111111111111111111111
11111111111111111111000000000000000001111111111111111111111111111110111111111111111111111111111111111
11111111111111111111011111111111100001111111111111111111111111111110111111111111111111111111111111111
11111111111111111111011111111111100001111111111111111111111111100000000001111111111111111111111111111
11111111111111111111011111111111100001111000000000001111111111100000000001111111111000000000111111111
1111111111111111111101111111111111000000000000000000000000000000000D000000000000000000000000111111111
11111111111111111111011111111111111111111000000000000000000000000000000000000000000000000000111111111
11111111111111111111011111111111111111111000000000001111111111100000000001111111111000000000111111111
11111000000000011111011111111111111111111000000000001111111111111110111111111111111111111111111111111
11111000000000000000000000000000000000000001000000001111111111111110111111111111111111111111111111111
11111000000000011111011111111111111111111111111111111111111111111110111111111111111111111111111111111
11111000000000011111011111111111111111111111111111111111111111111110111111111111111111111111111111111
11111111101111111111011111111111111111111111111111111111111111111110111111111111111111111111111111111
11111111101111111111011111111111111111111111111111111111111111111110111111111111111111111111111111111
11111111101111111111011111111111111111111111111111111111111111111110111111111111111111111111111111111
11111111101111111111011111111111111111111111111111111111111111111110111111111111111111111111111111111
11111111101111111111011111111111111111111111111111111111111111111110111111111111111111111111111111111
11111111101111111111011111111111111111111111111111111111111111111110111111111111111111111111111111111
11111111101111111111011111111111111111111111111111111111111111111110111111111111111111111111111111111
11111111101111111111011111111111111111111111111111111111111111111110111111111111111111111111111111111
11111111101111111111011111111111111111111111111111111111111111111000000111111111111111111111111111111
11111111101111111111011111111111111111111111111111111111111111111000000111111111111111111111111111111
11111111100000000000000000000000000000000000000000000000000000000000000111111111111111111111111111111
11111111111111111111011111111111111111111111111111111111111111111000000111111111111111111111111111111
11111111111111111111011111111111111111111111111111111111111111111000000111111111111111111111111111111
11111111111111111111011111111111111111111111111111111111111111111000000111111111111111111111111111111
11111111111111111000000001111111111111111111111111111111111111111110111111111111111111111111111111111
11111111111111111000000001111111111111111111111111111111111111111110111111111111111111111111111111111
11111111111111111000000001111111111111111111111111111111111111111110111111111111111111111111111111111
11111111111111111000000000000000000000000000000000000000000000000000111111111111111111111111111111111
11111111111111111000000001111111111111111111111111111111111111111111111111111111111111111111111111111
11111111111111111000000001111111111111111111111111111111111111111111111111111111111111111111111111111
11111111111111111000000001111111111111111111111111111111111111111111111111111111111111111111111111111
11111111111111111111111111111111111111111111111111111111111111111111111111111111111111111111111111111
11111111111111111111111111111111111111111111111111111111111111111111111111111111111111111111111111111
11111111111111111111111111111111111111111111111111111111111111111111111111111111111111111111111111111
11111111111111111111111111111111111111111111111111111111111111111111111111111111111111111111111111111
11111111111111111111111111111111111111111111111111111111111111111111111111111111111111111111111111111
11111111111111111111111111111111111111111111111111111111111111111111111111111111111111111111111111111
11111111111111111111111111111111111111111111111111111111111111111111111111111111111111111111111111111
11111111111111111111111111111111111111111111111111111111111111111111111111111111111111111111111111111
11111111111111111111111111111111111111111111111111111111111111111111111111111111111111111111111111111
11111111111111111111111111111111111111111111111111111111111111111111111111111111111111111111111111111
11111111111111111111111111111111111111111111111111111111111111111111111111111111111111111111111111111
11111111111111111111111111111111111111111111111111111111111111111111111111111111111111111111111111111
11111111111111111111111111111111111111111111111111111111111111111111111111111111111111111111111111111
