NO      ./graphic/NO.xpm
SO      ./graphic/SO.xpm
WE      ./graphic/WE.xpm
EA      ./graphic/EA.xpm
DO      ./graphic/DO.xpm

F 153,102,190
C 234,143,163

1111111111111111111111111111111111111111111111111111111111111
1111111111111111111111111111111111111111111111111111111111111
1111111111111111111111111111111111111111111111111111111111111
1111111111111111111111111111111111111111111111111111111111111
1111111111111111111111111111111111111111111111111111111111111
1111111111111111111111111111111111111111111111111111111111111
1111111111111111111111111111111111111111111111111111111111111
1111111111111111111111111111111111111111111111111111111111111
1111111111111111111111111111111111111111111111111111111111111
1111111111111111111111111111111111111111111111111111111111111
1111111111111111111111111111111111111111111111111111111111111
1111111111111111111111111111111111111111111111111111111111111
1111111111111111111111111111111111111111111111111111111111111
1111111111111111111111111111111111111111111111111111111111111
1111111111111111111111111111111111111111111111111111111111111
1111111111111111111111111111111111111111111111111111111111111
1111111111111111111111111111111111111111111111111111111111111
1111111111111111111111111111111111111111111111111111111111111
1111111111111111111111111111111111111111111111111111111111111
1111111111111111111111111111111111111111111111111111111111111
1111111111111111111111111111111111111111111111111111111111111
1111111111111111111111111111111111111111111111111111111111111
1111111111111111111111111111111111111111111111111111111111111
1111111111111111111111111111111111111111111111111111111111111
1111111111111111111100000111111111111111111111111111111111111
1111111111111111111100000000000000111111111111111111111111111
1111111111111111111100000111111110111111111111111111111111111
1111111111111111111100000111111110111111111111111111111111111
1111111111111111111111011111111110111111111111111111111111111
1111100000111111111111011111111110111111111111111111111111111
1111100000111111111111011111111110111111111111111111111111111
1111100000111111111111011111111110111111111111111111111111111
1111100D00111111111111011111111110111111111111111111111111111
1111100000111111111111011111111110111111111111111111111111111
1111100000111111111111011111111110111111111111111111111111111
1100000000111111111111011111111110111111111111111111111111111
1100001011111111111111011111111110111111111111111111111111111
1100000000000000011111011111100000000011111111111111111111111
1100001011111111011111011111110000000011111111111111111111111
1100001011111111011111011111100000000011111111111111111111111
1110111011111111000000000000000000000011111111111111111111111
1110111011111111001111011110000000000011111111111111111111111
1110100000000000000000000000N00000000011111111111111111111111
1110101011111111001111011110000000000011111111111111111111111
1110101011111111001111011110000111111111111111111111111111111
1110101011111111001111011110000111111111111111111111111111111
1110101011111111001111011111111111111111111111111111111111111
1110101011111111001111011111111111111111111111111111111111111
1110101011111111001111011111111111111111111111111111111111111
1110101011111111001111011111111111111111111111111111111111111
1110101011111111001111011111111111111111111111111111111111111
1110101011111111001111011111111111111111111111111111111111111
1110101011111111001111011111111111111111111111111111111111111
1110101011111111001111011111111111111111111111111111111111111
1110101011111111001111011111111111111111111111111111111111111
1110101011111100000011011111111111111111111111111111111111111
1110101011111100000011011111111111111111111111111111111111111
1110101011111100000011011111111111111111111111111111111111111
1110101000000000000011011111111111111111111111111111111111111
1110101111111100000011011111111111111111111111111111111111111
1110000000000000000011011111111111111111111111111111111111111
1111101111111100000011011111111111111111111111111111111111111
1111101111111100000011011111111111111111111111111111111111111
1111101111111111111111011111111111111111111111111111111111111
1111101111111111111111011111111111111111111111111111111111111
1111101111111111111111011111111111111111111111111111111111111
1111101111111111111111011111111111111111111111111111111111111
1111101111111111111111011111111111111111111111111111111111111
1111101111111111111111011111111111111111111111111111111111111
1111101111111111111111011111111111111111111111111111111111111
1111101111111111111111011111111111111111111111111111111111111
1111101111111111111111011111111111111111111111111111111111111
1111101111111111111111011111111111111111111111111111111111111
1111101111111111111111011111111111111111111111111111111111111
1111101111111111111111011111111111111111111111111111111111111
1111101111111111111111011111111111111111111111111111111111111
1111101111111111111111011111111111111111111111111111111111111
1111101111111111111111011111111111111111111111111111111111111
1111101111111111111111011111111111111111111111111111111111111
1111101111111111111111011111111111111111111111111111111111111
1111101111111111111111011111111111111111111111111111111111111
1111101111111111111111011111111111111111111111111111111111111
1111101111111111111111011111111111111111111111111111111111111
1111101111111111111111011111111111111111111111111111111111111
1111101111111111111111011111111111111111111111111111111111111
1111101111111111111111011111111111111111111111111111111111111
1111101111111111111111011111111111111111111111111111111111111
1111101111111111111111011111111111111111111111111111111111111
1111101111111111111111011111111111111111111111111111111111111
1111101111111111111111011111111111111111111111111111111111111
1111101111111111111111011111111111111111111111111111111111111
1111101111111111111111011111111111111111111111111111111111111
1111101111111111111111011111111111111111111111111111111111111
1111101111111111111111011111111111111111111111111111111111111
1111101111111111111111011111111111111111111111111111111111111
1111101111111111111111011111111111111111111111111111111111111
1111101111111111111111011111111111111111111111111111111111111
1111101111111111111111011111111111111111111111111111111111111
1111101111111111111111011111111111111111111111111111111111111
1111101111111111111111011111111111111111111111111111111111111
1111101111111111111111011111111111111111111111111111111111111
1111101111111111111111011111111111111111111111111111111111111
1111101111111111111111011111111111111111111111111111111111111
1111101111111111111111011111111111111111111111111111111111111
1110000011111111111111011111111111111111111111111111111111111
1110000011111111111111011111111111111111111111111111111111111
1110000000000000000000011111111111111111111111111111111111111
1110100011111111111111111111111111111111111111111111111111111
1110000011111111111111111111111111111111111111111111111111111
1110000011111111111111111111111111111111111111111111111111111
1111111111111111111111111111111111111111111111111111111111111
1111111111111111111111111111111111111111111111111111111111111
1111111111111111111111111111111111111111111111111111111111111
1111111111111111111111111111111111111111111111111111111111111
1111111111111111111111111111111111111111111111111111111111111
1111111111111111111111111111111111111111111111111111111111111
1111111111111111111111111111111111111111111111111111111111111
1111111111111111111111111111111111111111111111111111111111111
1111111111111111111111111111111111111111111111111111111111111
1111111111111111111111111111111111111111111111111111111111111
1111111111111111111111111111111111111111111111111111111111111
1111111111111111111111111111111111111111111111111111111111111
1111111111111111111111111111111111111111111111111111111111111
1111111111111111111111111111111111111111111111111111111111111
1111111111111111111111111111111111111111111111111111111111111
1111111111111111111111111111111111111111111111111111111111111
1111111111111111111111111111111111111111111111111111111111111
1111111111111111111111111111111111111111111111111111111111111
1111111111111111111111111111111111111111111111111111111111111
1111111111111111111111111111111111111111111111111111111111111
1111111111111111111111111111111111111111111111111111111111111
1111111111111111111111111111111111111111111111111111111111111
1111111111111111111111111111111111111111111111111111111111111
1111111111111111111111111111111111111111111111111111111111111
1111111111111111111111111111111111111111111111111111111111111
1111111111111111111111111111111111111111111111111111111111111
1111111111111111111111111111111111111111111111111111111111111
1111111111111111111111111111111111111111111111111111111111111
1111111111111111111111111111111111111111111111111111111111111
1111111111111111111111111111111111111111111111111111111111111
1111111111111111111111111111111111111111111111111111111111111
1111111111111111111111111111111111111111111111111111111111111
1111111111111111111111111111111111111111111111111111111111111
1111111111111111111111111111111111111111111111111111111111111
1111111111111111111111111111111111111111111111111111111111111
1111111111111111111111111111111111111111111111111111111111111
1111111111111111111111111111111111111111111111111111111111111
1111111111111111111111111111111111111111111111111111111111111
1111111111111111111111111111111111111111111111111111111111111
1111111111111111111111111111111111111111111111111111111111111
1111111111111111111111111111111111111111111111111111111111111
1111111111111111111111111111111111111111111111111111111111111
1111111111111111111111111111111111111111111111111111111111111
1111111111111111111111111111111111111111111111111111111111111
1111111111111111111111111111111111111111111111111111111111111
1111111111111111111111111111111111111111111111111111111111111
1111111111111111111111111111111111111111111111111111111111111
1111111111111111111111111111111111111111111111111111111111111
1111111111111111111111111111111111111111111111111111111111111
1111111111111111111111111111111111111111111111111111111111111
1111111111111111111111111111111111111111111111111111111111111
1111111111111111111111111111111111111111111111111111111111111
1111111111111111111111111111111111111111111111111111111111111
1111111111111111111111111111111111111111111111111111111111111
1111111111111111111111111111111111111111111111111111111111111
1111111111111111111111111111111111111111111111111111111111111
1111111111111111111111111111111111111111111111111111111111111
1111111111111111111111111111111111111111111111111111111111111
1111111111111111111111111111111111111111111111111111111111111
1111111111111111111111111111111111111111111111111111111111111
1111111111111111111111111111111111111111111111111111111111111
1111111111111111111111111111111111111111111111111111111111111
1111111111111111111111111111111111111111111111111111111111111
1111111111111111111111111111111111111111111111111111111111111
1111111111111111111111111111111111111111111111111111111111111
1111111111111111111111111111111111111111111111111111111111111
1111111111111111111111111111111111111111111111111111111111111
1111111111111111111111111111111111111111111111111111111111111
