NO      ./graphic/NO.xpm
SO      ./graphic/SO.xpm
WE      ./graphic/WE.xpm
EA      ./graphic/EA.xpm
DO      ./graphic/DO.xpm

F 108,182,83
C 237,232,147

                                                                                                                                                            
                                                                                                                                                            
                                                                                                                                                            
                                                                                                                                                            
                                                                                                                                                            
                                                                                                                                                            
                                                                                                                                                            
                                                                                                                                                            
                                                                                                                                                            
                                                                                                                                                            
                                                                                                                                                            
                                                                                                                                                            
                                                                                                                                                            
                                                                                                                                                            
                                                                                                                                                            
                                                                                                                                                            
            11111111111111111111111111111111111111111111111111111111111111111111111111111111111111111111111111111111111111                                  
           1000000000000000000000000000000000000000000000000000000000000000000000000000000000000000000000000000000000000001                                 
           10000000000000000000000000000000000000000000000000000000000000000000000000000000000000000000000000000000000000011                                
           100000000000000000000000000000000000000000000000000000000000000000000000000000000000000000000000000000000000000001                               
           100000000000000000000000000000000000000000000000000000000000000000000000000000000000000000000000000000000000000001                               
           100000000000000000000000000000000000000000000000000000000000000000000000000000000000000000000000000000000000000001                               
           100000000011111111111111111111111111111111111111111111111111111111111111111111111111111111111111111111111111000001                               
            110000011                                                                                                 1000001                               
             1000001                                                                                                  1000001                               
             1000001                                                                                                  1000001                               
             1000001                                                                                                  1000001                               
             1000001                                                                                                  1000001                               
             1000001                                                                                                  1000001                               
             1000001                                                                                                  1000001                               
             1000001                                                                                                  1000001                               
             1000001                                                                                                  1000001                               
             1000001                                                                                                  1000001                               
             1000001                                                                                                  1000001                               
             1000001                                                                                                  1000001                               
             1000001                                                                             11111                1000001                               
             1000001                               1111111111111111111111111111111111111111111111000001               1000001                               
             1000001                              10000000000000000000000000000000000000000000000000001               1000001                               
             1000001                             110000000000000000000000000000000000000000000000000001               1000001                               
             1000001                            1000000000000000000000000000000000000000000000000000001               1000001                               
             1000001                            1000000000000000000000000000000000000000000000000000001               1000001                               
             1000001                            1000000000000000000000000000000000000000000000000000001               1000001                               
             1000001                            1000001111111111111111111111111111111111111111111000001               1000001                               
             1000001                            1000001                                         1000001               1000001                               
             1000001                            1000001                                         1000001               1000001                               
             1000001                            1000001                                         1000001               1000001                               
             1000001                            1000001                                         1000001               1000001                               
             1000001                            1000001                                         1000001               1000001                               
  111111111111000001                            10000011111111111111111111111111111111111111111110000011111111111111111000001                               
 1000000000000000001                            10000000000000000000000000000000000000000000000000000000000000000000000000001                               
 1000000000000000001                            10000000000000000000000000000000000000000000000000000000000000000000000000001                               
 1000000000000000001                            10000000000000000000000000000000000000000000000000000000000000000000000000001                               
 100000000000000011                             10000000000000000000000000000000000000000000000000000000000000000000000000001                               
 10000000000000001                              10000000000000000000000000000000000000000000000000000000000000000000000000001                               
  100000111111111                               10000000111111111111111111111111111111111111111110000011111111111111111000001                               
  1000001                                       100000001                                       1000001               1000001                               
  1000001                                       100000001                                       1000001                11111                                
  1000001                                       100000001                                       1000001                                                     
  1000001                                       100000001                                       1000001                                                     
  1000001                                       100000001                                       1000001                                                     
  1000001                                       100000001                                       1000001                                                     
  1000001                                       100000001                                       1000001                                                     
  1000001                                       100000001                                       1000001                                                     
  1000001                                       100000001                                       1000001                                                     
  1000001                                       100000001                                       1000001                                                     
  1000001                                       100000001                                       1000001                                                     
  1000001                                       100000001                                       1000001                                                     
  1000001                                       100000001                                       1000001                                                     
  1000001                                       100000001                                       1000001                                                     
  1000001                                       100000001                                       1000001                                                     
  1000001                                       100000001                                       1000001                                                     
  1000001                                       100000001                                       1000001                                                     
  1000001                                       100000001                                       1000001                                                     
  1000001                                       100000001                                       1000001                                                     
  1000001                                       1000000011                                      1000001                                                     
  1000001                                       10000000001                                     1000001                                                     
  1000001                                       10000000001                                     1000001                                                     
  1000001                                       10000000001                                     1000001                                                     
  1000001                                       10000D00001                                     1000001                                                     
  1000001                                       10000000001                                     1000001                                                     
  1000001                                       10000000001                                     1000001                                                     
  1000001                                       10000000001                                     1000001                                                     
  1000001                                       10000000001                                     1000001                                                     
  1000001                                       1000000011                                      1000001                                                     
  1000001                                       100000001                                       1000001                                                     
  1000001                                       100000001                                       1000001                                                     
  1000001                                       100000001                                       1000001                                                     
  1000001                                       100000001                                       1000001                                                     
  1000001                                       100000001                                       1000001                                                     
  1000001                                       100000001                                       1000001                                                     
  1000001                                       100000001                                       1000001                                                     
  1000001                                       100000001                                       1000001                                                     
  1000001                                       1000000011                                      1000001                                                     
  1000001                                       1000000000111111111111111111111111111111111111111000001                                                     
  1000001                                       1000000000000000000000000000000000000000000000000000001                                                     
  1000001                                       1000000000000000000000000000000000000000000000000000001                                                     
  1000001                                       1000000000000000000000000000000000000000000000000000001                                                     
  1000001                                       100000000000000000000000000000000000000000000000000011                                                      
  1000001                                       10000000000000000000000000000000000000000000000000001                                                       
  1000001                                       1000000000111111111111111111111111111111111111111111                                                        
  1000001                                       1000000011                                                                                                  
  1000001                                       100000001                                                                                                   
  1000001                                       100000001                                                                                                   
  1000001                                       100000001                                                                                                   
  1000001                                       100000001                                                                                                   
  1000001                                       100000001                                                                                                   
  1000001                                       100000001                                                                                                   
  1000001                                       100000001                                                                                                   
  1000001                                       100000001                                                                                                   
  1000001                                       100000001                                                                                                   
  1000001                                       100000001                                                                                                   
  1000001                                       100000001                                                                                                   
  1000001                                       100000001                                                                                                   
  1000001                                       100000001                                                                                                   
  1000001                                       100000001                                                                                                   
  1000001                                       100000001                                                                                                   
  1000001                                       100000001                                                                                                   
  1000001                                       100000001                                                                                                   
  1000001                                       100000001                                                                                                   
  1000001                                       100000001                                                                                                   
  1000001                                       100000001                                                                                                   
  1000001                                       100000001                                                                                                   
  1000001                                       100000001                                                                                                   
  1000001                                       100000001                                                                                                   
  1000001                                       100000001                                                                                                   
  1000001                                       100000001                                                                                                   
  1000001                                       100000001                                                                                                   
  1000001                                       100000001                                                                                                   
  1000001                                       100000001                                                                                                   
  1000001                                       100000001                                                                                                   
  1000001                                       100000001                                                                                                   
  1000001                                       100000001                                                                                                   
  1000001                                       100000001                                                                                                   
  1000001                                       100000001                                                                                                   
  1000001                                       100000001                                                                                                   
  1000001                                       100000001                                                                                                   
  1000001                                       100000001                                                                                                   
  1000001                                       100000001                                                                                                   
  1000001                                       100000001                                                                                                   
  1000001                                       100000001                                                                                                   
  1000001                                       100000001                                                                                                   
  1000001                                       100000001                                                                                                   
  1000001                                      1000000001                                                                                                   
  1000001                                      1000000001                                                                                                   
  1000001                                      1000000001                                                                                                   
  1000001                                      1000000001                                                                                                   
  1000001                                       11111111                                                                                                    
  1000001                                                                                                                                                   
  1000001                                                                                                                                                   
  1000001                                                                                                                                                   
  1000001                                                                                                                                                   
  1000001111111111111111111111111111111                                                                                                                     
  10000000000000000000000000000000000001                                                                                                                    
  10000000000000000000000000000000000001                                                                                                                    
  100000000000000000000000000000000N0001                                                                                                                    
   1100000000000000000000000000000000001                                                                                                                    
    100000000000000000000000000000000001                                                                                                                    
     1111111111111111111111111111111111                                                                                                                     
                                                                                                                                                            
