NO      ./graphic/NO.xpm
SO      ./graphic/SO.xpm
WE      ./graphic/WE.xpm
EA      ./graphic/EA.xpm
DO      ./graphic/DO.xpm

F 174,110,136
C 185,235,230

                                                                                                                                                                                               
                                                                                                                                                                                               
                                          11111111111111111111111111111111111111111111                                                                                                         
                                         1000000000000000000000000000000000000000000001                                                                                                        
                                         10000000000000000000000000000000000000000000011                                                                                                       
                                        1000000000000000000000000000000000000000000000001                                                                                                      
                                        1000000000000000000000000000000000000000000000001                                                                                                      
                                        1000000000000000000000000000000000000000000000001                                                                                                      
                                        1000001111111111111111111111111111111111111000001                                                                                                      
                                        1000001                                   1000001                                                                                                      
                                        1000001                                   1000001                                                                                                      
                                        1000001                                   1000001                                                                                                      
                                        1000001                                   1000001                                                                                                      
                                        1000001                                   1000001                                                                                                      
      1111111111111111111111111111111111100000111                                 1000001                                                                                                      
     100000000000000000000000000000000000000000001                                1000001                                                                                                      
    1100000000000000000000000000000000000000000001                                1000001                                                                                                      
   10000000000000000000000000000000000000000000001                                1000001                                                                                                      
   10000000000000000000000000000000000000000000001                                1000001                                                                                                      
   10000000000000000000000000000000000000000000001                                1000001                                                                                                      
   1000001111111111111111111111111111111100000011                                 1000001                                                                                                      
   1000001                              10000001                              11111000001                                                                                                      
   1000001                              10000001                             100000000001                                                                                                      
   1000001                              10000001                             100000000001                                                                                                      
   1000001                              10000001                             100000000001                                                                                                      
   1000001                              10000001                             100D00000001                                                                                                      
   1000001                              10000001                             100000000001                                                                                                      
   1000001                              10000001                             100000000001                                                                                                      
   1000001                              10000001                             100000000001                                                                                                      
   1000001                              10000001                             100000000001                                                                                                      
   1000001                              10000001                             100000000001                                                                                                      
   1000001                              10000001                             100000000001                                                                                                      
   1000001                              10000001                             100000000001                                                                                                      
   1000001                              10000001                             100000000001                                                                                                      
   1000001                              10000001                             100000000001                                                                                                      
   1000001                              10000001                             100000000001                                                                                                      
   1000001                              10000001                             100000000001                                                                                                      
   1000001                              10000001                             100000000001                                                                                                      
   1000001                              10000001                             100000000001                                                                                                      
   1000001                              10000001                             100000000001                                                                                                      
   1000001                              10000001                             100000000001                                                                                                      
   1000001                              10000001                             100000000001                                                                                                      
   1000001                              10000001                             100000000001                                                                                                      
   1000001                              10000001                             100000000001                                                                                                      
   1000001                              10000001                             100000000001                                                                                                      
   1000001                              10000001                             100000000001                                                                                                      
   1000001                              10000001                             100000000001                                                                                                      
   1000001                              10000001                             100000000001                                                                                                      
   1000001                              10000001                             100000000001                                                                                                      
   1000001                              10000001                             100000000001                                                                                                      
   1000001                              10000001                             100000000001                                                                                                      
   1000001                              10000001                              11000000001                                                                                                      
   1000001                              10000001                               1000000001                                                                                                      
   1000001                              10000001111111111111111111111111111111111111111111111111111111111111111111111111111111111111                                                           
   1000001                              10000000000000000000000000000000000000000000000000000000000000000000000000000000000000000000111111111111111111111111111111111111111111111111111        
   1000001111111111111111111111111111111100000000000000000000000000000000000000000000000000000000000000000000000000000000000000000000000000000000000000000000000000000000000000000000001       
   1000000000000000000000000000000000000000000000000000000000000000000000000000000000000000000000000000000000000000000000000000000000000000000000000000000000000000000000000000000000001       
   1000000000000000000000000000000000000000000000000000000000000000000000000000000000000000000000000000000000000000000000000000000000000000000000000000000000000000000000000000000000001       
   1000000000000000000000000000000000000000000000000000000000000000000000000000000000000000000000000000000000000000000000000000000000000000000000000000000000000000000000000000000000001       
    100000000000000000000000000000000000000000000000000000000000000000000000000000000000000000000000000000000000000000000000000000000000000000000000000000000000000000000000000000000001       
    10000000000000000000000000000000000000000000000000000000000000000000000000000000000000000000000000000000000000000000000000000011111111111111111111111111111111111111111111100000111        
    100001111111111111111111111111111111111111111111111111111111111111111111111111111111111111111111111111111111111111111111111111                                            1000001          
     1111                                                                                                                                                                     1000001          
                                                                                                                                                                              1000001          
                                                                                                                                                                              1000001          
                                                                                                                                                                              1000001          
                                                                                                                                                                              1000001          
                                                                                                                                                                              1000001          
                                                                                  111111111111111111111111111111111111111111111111111111111111111111111111111111111111111111111000001          
                                                                                 1000000000000000000000000000000000000000000000000000000000000000000000000000000000000000000000000001          
                                                                                 1000000000000000000000000000000000000000000000000000000000000000000000000000000000000000000000000001          
                                                                                 100N000000000000000000000000000000000000000000000000000000000000000000000000000000000000000000000001          
                                                                                 100000000000000000000000000000000000000000000000000000000000000000000000000000000000000000000000011           
                                                                                 10000000000000000000000000000000000000000000000000000000000000000000000000000000000000000000000001            
                                                                                 1000001111111111111111111111111111111111111111111111111111111111111111111111111111111111111111111             
                                                                                  11111                                                                                                        
                                                                                                                                                                                               
                                                                                                                                                                                               
                                                                                                                                                                                               
                                                                                                                                                                                               
                                                                                                                                                                                               
                                                                                                                                                                                               
                                                                                                                                                                                               
                                                                                                                                                                                               
                                                                                                                                                                                               
                                                                                                                                                                                               
                                                                                                                                                                                               
                                                                                                                                                                                               
                                                                                                                                                                                               
                                                                                                                                                                                               
                                                                                                                                                                                               
                                                                                                                                                                                               
                                                                                                                                                                                               
                                                                                                                                                                                               
                                                                                                                                                                                               
                                                                                                                                                                                               
                                                                                                                                                                                               
                                                                                                                                                                                               
                                                                                                                                                                                               
                                                                                                                                                                                               
                                                                                                                                                                                               
                                                                                                                                                                                               
                                                                                                                                                                                               
                                                                                                                                                                                               
                                                                                                                                                                                               
                                                                                                                                                                                               
                                                                                                                                                                                               
                                                                                                                                                                                               
                                                                                                                                                                                               
                                                                                                                                                                                               
                                                                                                                                                                                               
                                                                                                                                                                                               
                                                                                                                                                                                               
                                                                                                                                                                                               
                                                                                                                                                                                               
                                                                                                                                                                                               
                                                                                                                                                                                               
                                                                                                                                                                                               
                                                                                                                                                                                               
                                                                                                                                                                                               
                                                                                                                                                                                               
                                                                                                                                                                                               
                                                                                                                                                                                               
                                                                                                                                                                                               
                                                                                                                                                                                               
                                                                                                                                                                                               
                                                                                                                                                                                               
                                                                                                                                                                                               
                                                                                                                                                                                               
                                                                                                                                                                                               
                                                                                                                                                                                               
                                                                                                                                                                                               
                                                                                                                                                                                               
                                                                                                                                                                                               
                                                                                                                                                                                               
                                                                                                                                                                                               
                                                                                                                                                                                               
                                                                                                                                                                                               
                                                                                                                                                                                               
                                                                                                                                                                                               
                                                                                                                                                                                               
                                                                                                                                                                                               
                                                                                                                                                                                               
                                                                                                                                                                                               
