NO      ./graphic/NO.xpm
SO      ./graphic/SO.xpm
WE      ./graphic/WE.xpm
EA      ./graphic/EA.xpm
DO      ./graphic/DO.xpm

F 115,120,132
C 154,177,244

11111111111111111111111111111111111111111111111111111111111111111111111111111111111111111111111111111
11111111111111111111111111111111111111111111111111111111111111111111111111111111111111111111111111111
11111111111111111111111111111111111111111111111111111111111111111111111111111111111111111111111111111
11111111111111111111111111111111111111111111111111111111111111111111111111111111111111111111111111111
11111111111111111111111111111111111111111111111111111111111111111111111111111111111111111111111111111
11111111111111111111111111111111111111111111111111111111111111111111111111111111111111111111111111111
11111111111111111111111111111111111111111111111111111111111111111111111111111111111111111111111111111
11111111111111111111111111111111111111111111111111111111111111111111111111111111111111111111111111111
11111111111111111111111111111111111111111111111111111111111111111111111111111111111111111111111111111
11111111111111111111111111111111111111111111111111111111111111111111111111111111111111111111111111111
11111111111111111111111111111111111111111111111111111111111111111111111111111111111111111111111111111
11111111111111111111111111111111111111111111111111111111111111111111111111111111111111111111111111111
11111111111111111111111111111111111111111111111111111111111111111111111111111111111111111111111111111
11111111111111111111111111111111111111111111111111111111111111111111111111111111111111111111111111111
11111111111111111111111111111111111111111111111111111111111111111111111111111111111111111111111111111
11111111111111111111111111111111111111111111111111111111111111111111111111111111111111111111111111111
11111111111111111111111111111111111111111111111111111111111111111111111111111111111111111111111111111
11111111111111111111111111111111111111111111111111111111111111111111111111111111111111111111111111111
11111111111111111111111111111111111111111111111111111000011111111111111111111111111111111111111111111
11111111111111111111111111111111111111111111111111111000011111111111111111111111111111111111111111111
11111111111111111111111111111111111111111111111111111000011111111111111111111111110000000011111111111
11111111111111111111111111111111111111111111111111111000000000000001111111111111110000000011111111111
11111111111111111111111111111111111111111111111111111000000000000000000000000000000000000011111111111
11111111111111111111111111111111111111111111111111111000011111111101111111111111110000000011111111111
11111111111111111111111111111111111111111111111111111000011111111101111111111111111000000011111111111
11111111111111111111111111111111111111111111111111111111111000000000001111111111111110111111111111111
11111111111111111111111111111111111111111111111111111111111000000000001111111111111110111111111111111
1111111111111111111110000000000000100000000000000000000000000000W000001111111111111110111111111111111
11111111111111111111101111111111111111111111111111111111111000000000001111111111111110111111111111111
11111111111111111111101111111111111111111111111111111111111000000000001111111111111110111111111111111
11111111111111111111101111111111111111111111111111111111111000000000001111111111111110111111111111111
11111111111111111111101111111111111111111111111111111111111111111101111111111111111110111111111111111
11111111111111111111101111111111111111111111111111111111111111111101111111111111111110111111111111111
11111111111111111111101111111111111111111111111111111111111111111101111111111111111110111111111111111
11111111111111111111101111111111111111111111111111111111111111111101111111111111111110111111111111111
11111111111111111111101111111111111111111111111111111111111111111101111111111111111110111111111111111
11111111111111111111101111111111111111111111111111111111111111111101111111111111111110111111111111111
11111111111111111111101111111111111111111111111111111111111111111101111111111111111110111111111111111
11111111111111111111101111111111111111111111111111111111111111111101111111111111111110111111111111111
11111111111111111111101111111111111111111111111111111111111111111101111111111111111110111111111111111
11111111111111111111101111111111111111111111111111111111111111111101111111111111111110111111111111111
11111111111111111111101111111111111111111111111111111111111111111101111111111111111110111111111111111
11111111111111111111101111111111111111111111111111111111111111111101111111111111111110111111111111111
11111111111111111111101111111111111111111111111111111111111111111101111111111111111110111111111111111
11111111111111111111101111111111111111111111111111111111111111111101111111111111111110111111111111111
11111111111111111111101111111111111111111111111111111111111111111101111111111111111110111111111111111
11111111111111111111101111111111111111111111111111111111111111111101111111111111111110111111111111111
11111111111111111111101111111111111111111111111111111111111111111101111111111111111110111111111111111
11111111111111111111101111110000000011111111111111111111111111111101111111111111111110111111111111111
11111111111111111111101111110000000011111111111111111111111111111101111111111111111110111111111111111
11111111111111111111101111110000000000000000000000000000000000000000000011111111111110111111111111111
11111111111111111111101111110000000011111111111111111111111111111101111011111111111110111111111111111
11111111111111111111101111110000000011111111111111111111111111111101111011111111111110111111111111111
11111111111111111111101111110000000011111111111111111111111111111101111011111111111110111111111111111
11111111111111111111101111111110111111111111111111111111111111111101111011111111111110111111111111111
11111111111111111111101111111110111111111111111111111111111111111101111011111111111110111111111111111
11111111111111111111101111111110111111111111111111111111111111111101111011111111111110111111111111111
11111111111111111111101111111110111111111111111111111111111111111101111011111111111110111111111111111
11111111111111111111101111111110111111111111111111111111111111111101111011111111111110111111111111111
11111111111111111111101111111110111111111111111111111111111111111101111011111111111110111111111111111
11111111111111111111101111111110111111111111111111111111111111111101111011111111111110111111111111111
11111111111111111111101111111110111111111111111111111111111111111101111011111111111110111111111111111
11111111111111111111101111111110111111111111111111111111111111111101111011111111111110111111111111111
11111111111111111111101111111110111111111111111111111111111111111101111011111111111110111111111111111
11111111111111111111101111111110111111111111111111111111111111111101111011111111111110111111111111111
11111111111111111111101111111110111111111111111111111111111111111101111011111111111110111111111111111
11111111111111111111101111111110111111111111111111111111111111111101111011111111111110111111111111111
11111111111111111111101111111110111111111111111111111111111111111101111011111111111110111111111111111
11111111111111111111101111111110111111111111111111111111111111111101111011111111111110111111111111111
11111111111111111111101111111110111111111111111111111111111111111101111011111111111110111111111111111
11111111111111111111101111111110111111111111111111111111111111111101111011111111111110111111111111111
11111111111111111111101111111110111111111111111111111111111111111101111011111111111110111111111111111
11111111111111111111101111111110111111111111111111111111111111111101111011111111111110111111111111111
11111111111111111111101111111110111111111111111111111111111111111101111011111111111110111111111111111
11111111111111111111101111111110111111111111111111111111111111111101111011111111111110111111111111111
11111111111111111111101111111110111111111111111111111111111111111101111011111111111110111111111111111
11111111111111111111101111111110111111111111111111111111111111111101111011111111111110111111111111111
11111111111111111111101111111110111111111111111111111111111111111101111011111111111110111111111111111
11111111111111111111101111111110111111111111111111111111111111111101111011111111111110111111111111111
11111111111111111111101111111110111111111111111111111111111111111101111011111111111110111111111111111
11111111111111111111101111111110111111111111111111111111111111111101111011111111111110111111111111111
11111111111111111111101111111110111111111111111111111111111111111101111011111111111110111111111111111
11111111111111111111101111111110111111111111111111111111111111111101111011111111111110111111111111111
11111111111111111111101111111110111111111111111111111111111111111101111011111110000000000111111111111
11111111111111111111101111111110111111111111111111111111111111111101111011111110000000000111111111111
11111111111111111111101111111110000000000000000000000000000000000000000000000000000000000111111111111
11111111111111111111101111111111111111111111111111111111111111111101111011111110000000000111111111111
11111111111111111111101111111111111111111111111111111111111111111101111011111110000000000111111111111
11111111111111111111101111111111111111111111111111111111111111111101111011111110000000000111111111111
11111111111111111111101111111111111111111111111111111111111111111101111011111111111010111111111111111
11111111111111111111101111111111111111111111111111111111111111111101111011111111111010111111111111111
11111111111111111111101111111111111111111111111111111111111111111101111011111111111010111111111111111
11111111111111111111101111111111111111111111111111111111111111111101111011111111111010111111111111111
11111111111111111111101111111111111111111111111111111111111111111101111011111111111010111111111111111
11111111111111111111101111111111111111111111111111111111111111111101111011111111111010111111111111111
11111111111111111111101111111111111111111111111111111111111111111101111011111111111010111111111111111
11111111111111111111101111111111111111111111111111111111111111111101111011111111111010111111111111111
11111111111111111111101111111111111111111111111111111111111111111101111011111111111010111111111111111
11111111111111111111101111111111111111111111111111111111111111111101111011111111111010111111111111111
11111111111111111111101111111111111111111111111111111111111111111101111011111111111010111111111111111
11111111111111111111101111111111111111111111111111111111111111111101111011111111111010111111111111111
11111111111111111111101111111111111111111111111111111111111111111101111011111111111010111111111111111
11111111111111111111101111111111111111111111111111111111111111111101111011111111111010111111111111111
11111111111111111111101111111111111111111111111111111111111111111101111011111111111010111111111111111
11111111111111111111101111111111111111111111111111111111111111111101111011111111111010111111111111111
11111111111111111111101111111111111111111111111111111111111111111101111011111111111010111111111111111
11111111111111111111101111111111111111111111111111111111111111111101111011111111111010111111111111111
11111111111111111111101111111111111111111111111111111111111111111101111011111111111010111111111111111
11111111111111111111101111111111111111111111111111111111111111111101111011111111111010111111111111111
11111111111111111111101111111111111111111111111111111111111111111101111111111111111010111111111111111
11111111111111111111101111111111111111111111111111111111111111111101111011111111111010111111111111111
11111111111111111111101111111111111111111111111111111111111111111101111011111111111010111111111111111
11111111111111111111101111111111111111111111111111111111111111111101111011111111111010111111111111111
11111111111111111111101111111111111111111111111111111111111111111101111011111111111010111111111111111
11111111111111111111101111111111111111111111111111111111111111111101111011111111111010111111111111111
11111111111111111111101111111111111111111111111111111111111111111101111011111111111010111111111111111
11111111111111111111101111111111111111111111111111111111111111111101111011111111111010111111111111111
11111111111111111111101111111111111111111111111111111111111111111101111011111111111010111111111111111
11111111111111111111101111111111111111111111111111111111111111111000011011111111111010111111111111111
11111111111111111111101111111111111111111111111111111111111111111000011011111111111010111111111111111
11111111111111111111101111111111111111111111111111111111111111111000011011111111111010111111111111111
11111111111111111111101111111111111111111111111111111111111111111000011011111111111010111111111111111
111111111111111111111011111111111111111111111111111111111111111110D0011011111111111010111111111111111
11111111111111111111101111111111111111111111111111111111111111111000011011111111111010111111111111111
11111111111111111111101111111111111111111111111111111111111111111000011011111111111010111111111111111
11111111111111111111101111111111111111111111111111111111111111111000011011111111111010111111111111111
11111111111111111111101111111111111111111111111111111111111111111000011011111111111010111111111111111
11111111111111111111101111111111111111111111111111111111111111111111111011111111111010111111111111111
11111111111111111111101111111111111111111111111111111111111111111111111011111111111010111111111111111
11111111111111111111101111111111111111111111111111111111111111111111111011111111111010111111111111111
11111111111111111111101111111111111111111111111111111111111111111111111011111111111010111111111111111
11111111111111111111101111111111111111111111111111111111111111111111111011111111111010111111111111111
11111111111111111111101111111111111111111111111111111111111111111111111011111111111010111111111111111
11111111111111111111101111111111111111111111111111111111111111111111111011111111111010111111111111111
11111111111111111100000001111111111111111111111111111111111111111111111011111111111010111111111111111
11111111111111111100000001111111111111111111111111111111111111111111111011111111111010111111111111111
11111111111111111100000000000000000000000000000000000000000000000000000000000000000010111111111111111
11111111111111111100000001111111111111111111111111111111111111111111000000001111111110111111111111111
11111111111111111100000001111111111111111111111111111111111111111111100000001111111110111111111111111
11111111111111111111111111111111111111111111111111111111111111111111000000001111111110111111111111111
11111111111111111111111111111111111111111111111111111111111111111111000000000000000000111111111111111
11111111111111111111111111111111111111111111111111111111111111111111000000001111111111111111111111111
11111111111111111111111111111111111111111111111111111111111111111111000000001111111111111111111111111
11111111111111111111111111111111111111111111111111111111111111111111000000001111111111111111111111111
11111111111111111111111111111111111111111111111111111111111111111111000000001111111111111111111111111
11111111111111111111111111111111111111111111111111111111111111111111111111111111111111111111111111111
11111111111111111111111111111111111111111111111111111111111111111111111111111111111111111111111111111
11111111111111111111111111111111111111111111111111111111111111111111111111111111111111111111111111111
11111111111111111111111111111111111111111111111111111111111111111111111111111111111111111111111111111
11111111111111111111111111111111111111111111111111111111111111111111111111111111111111111111111111111
11111111111111111111111111111111111111111111111111111111111111111111111111111111111111111111111111111
