NO      ./graphic/NO.xpm
SO      ./graphic/SO.xpm
WE      ./graphic/WE.xpm
EA      ./graphic/EA.xpm
DO      ./graphic/DO.xpm

F 76,82,77
C 166,163,255

1111111111111111111111111111111111111111111111111111111111111111111111111111111111111111111
1111111111111111111111111111111111111111111111111111111111111111111111111111111111111111111
1111111111111111111111111111111111111111111111111111111111111111111111111111111111111111111
1111111111111111111111111111111111111111111111111111111111111111111111111111111111111111111
1111111111111111111111111111111111111111111111111111111111111000000000001111111111111111111
1111111111111111111111111111111111111111111111111111111111111000000000001111111111111111111
1111111111111111111111111111111111111111111111000011111111111000000000001111111111111111111
1111111111111111111111111111111111111111111111000010000000000000000000001111111111111111111
1111111111111111111111111111111111111111111111010010111111111000000000001111111111111111111
11111111111111111111111111111111111111111111110D0010111111111000000000001111111111111111111
1111111111111111111111111111111111111111111111000010111111110000000000001111111111111111111
1111111111111111111111111111111111111111111111000000000011110000000000001111111111111111111
1111111111111111111111111111111111111111111111000000000011110000000111111111111111111111111
1111111111111111111111111111111111111111111111100000000011110000000111111111111111111111111
1111111111111111111111111111111111111111111111110000000000000000000111111111111111111111111
1111111111111111111111111111111111111111111111110000000011110000000111111111111111111111111
1111111111111111111111111111111111111111111111110000000011110000000111111111111111111111111
1111111111111111111111111111111111111111111111111011111111110000000111111111111111111111111
1111111111111111111111111000000001111111111111111011111111110000000111111111111111111111111
1111111111111111111111111000000001111111111111111011111111111101110111111111111111111111111
1111100000001111111111111000000000000000000000000000000100000001110111111111111111111111111
1111100010001111111111111000000001000011111111111011111111111111110111111111111111111111111
1111100000001111111111111000000001000000100000000000000000000000000111111111111111111111111
1111101000001111111111111000000001000011111110000000000111111111111111111111111111111111111
11111000W0100000000000000000011111000011111110000000000111111111111111111111111111111111111
1111100000001111111111111111111111000000000000000000000111111111111111111111111111111111111
1111100000001111111111111111111111111111111110000000000111111111111111111111111111111111111
1111100000001111111111111111111111111111111110000000000111111111111111111111111111111111111
1111100000001111111111111111111111111111111110000000000111111111111111111111111111111111111
1111111111111111111111111111111111111111111111111111111111111111111111111111111111111111111
1111111111111111111111111111111111111111111111111111111111111111111111111111111111111111111
1111111111111111111111111111111111111111111111111111111111111111111111111111111111111111111
