NO      ./graphic/NO.xpm
SO      ./graphic/SO.xpm
WE      ./graphic/WE.xpm
EA      ./graphic/EA.xpm
DO      ./graphic/DO.xpm

F 65,108,181
C 235,233,199

                                                                                                                                                                                                     
                                                                                                                                                                                                     
                                                                                                                                                                                                     
                                                                                                                                                                                                     
                                                                                                                                                                                                     
                                                                                                                                                                                                     
                                                                                                                                                                                                     
                                                                                                                                                                                                     
                                                                                                                                                                                                     
                                                                                                                                                                                                     
                                                                                                                                                                                                     
                                                                                                                                                                                                     
                                                                                                                                                                                                     
                                                                                         111111111111111111111111                                                                                    
                                                                                        10000000000000000000000001                                                                                   
                                                                                        100000000000000000000000011                                                                                  
                                                                                        1000000000000000000000000001                                                                                 
                                                                                        1000000000000000000000000001                                                                                 
                                                                                        1000000000000000000000000001                                                                                 
                                                                                        1000000000111111111111000001                                                                                 
                                               1111111111111111111111111111111111111111  110000011           1000001                                                                                 
                                              100000000000000000000000000000000000000001  1000001            1000001                                                                                 
                                             1100000000000000000000000000000000000000001  1000001            1000001                                                                                 
                                            10000000000000000000000000000000000000000001  1000001            1000001                                                                                 
                                            10000000000000000000000000000000000000000001  1000001            1000001                                                                                 
                                            10000000000000000000000000000000000000000001  1000001            1000001                                                                                 
                                            1000001111111111111111111111111111100000111   1000001            1000001                                                                                 
                                            1000001                           1000001     1000001            1000001                                                                                 
                                            1000001                           1000001111111000001111111111111100000111111111111111111111                                                             
                                            1000001                           10000000000000000000000000000000000000000000000000000000001                                                            
                                            1000001                           10000000000000000000000000000000000000000000000000000000001                                                            
                                            1000001                           10000000000000000000000000000000000000000000000000000000001                                                            
                                            1000001                            1100000000000000000000000000000000000000000000000000000001                                                            
                                            1000001                             100000000000000000000000000000000000000000000000000000001                                                            
                                            1000001                              11111111110000011111111111111000001111111111111111000001             111111                                         
                                            1000001                                       1000001            1000001              100000111111111111110000001                                        
                                            1000001                                       1000001            1000001              100000000000000000000000001                                        
                                            1000001                                       1000001            1000001              100000000000000000000000001                                        
                                            1000001                                       1000001            1000001              100000000000000000000000001                                        
                                            1000001                                       1000001            100000111111111111111111000000000000000000000001                                        
                                            1000001                                       1000001           1000000000000000000000000000000000000000000000001                                        
                                            1000001                                       1000001           1000000000000000000000000000000000000000000000001                                        
                                            1000001                                       1000001           1000000000000000000000000000000000000000000000001                                        
                                            1000001                                       1000001           100000000000000000000000000000000000000000000111                                         
                                            1000001                                       1000001           1000000000000000000000000000000000000000000001                                           
                                            1000001                                       1000001           100000001111111111111111111111111111111111111                                            
                                            1000001                                       1000001            1111111                                                                                 
                                            1000001                                       1000001                                                                                                    
                                            1000001                                       1000001                                                                                                    
                                            1000001                                       1000001                                                                                                    
                                            1000001                                       1000001                                                                                                    
                                            1000001                                       1000001                                                                                                    
                                            1000001                                       1000001                                                                                                    
                                            1000001                                       1000001                                                                                                    
                                            1000001                                       1000001                                                                                                    
                                            1000001                                       1000001                                                                                                    
                                            1000001                                       1000001                                                                                                    
                                            1000001                                       1000001                                                                                                    
                                            1000001                                       1000001                                                                                                    
                                            1000001                                       1000001                                                                                                    
                                            1000001                                       1000001                                                                                                    
                                            1000001                                       1000001                                                                                                    
                                            1000001                                       1000001                                                                                                    
                                            1000001                                       1000001                                                                                                    
                                            1000001                                       1000001                                                                                                    
                                            1000001                                       1000001                                                                                                    
                                            1000001                                       1000001                                                                                                    
                                            1000001                                       1000001                                                                                                    
                                            1000001                                       1000001                                                                                                    
                                            1000001                                       1000001                                                                                                    
                                            1000001                                       1000001                                                                                                    
          111111111111111111111111111111111110000011111111111111111111111111111111111111111000001                                                                                                    
         1000000000000000000000000000000000000000000000000000000000000000000000000000000000000001                                                                                                    
         1000000000000000000000000000000000000000000000000000000000000000000000000000000000000001                                                                                                    
         100E000000000000000000000000000000000000000000000000000000000000000000000000000000000001                                                                                                    
         100000000000000000000000000000000000000000000000000000000000000000000000000000000000011                                                                                                     
         10000000000000000000000000000000000000000000000000000000000000000000000000000000000001                                                                                                      
         1000000111111111111111111111111111110000011111111111111111111111111111111111111111111                                                                                                       
          111111                            1000001                                                                                                                                                  
                                            1000001                                                                                                                                                  
                                            1000001                                                                                                                                                  
                                            1000001                                                                                                                                                  
                                            1000001                                                                                                                                                  
                                            1000001                                                                                                                                                  
                                            1000001                                                                                                                                                  
                                            1000001                                                                                                                                                  
                                            1000001                                                                                                                                                  
                                            1000001                                                                                                                                                  
                                            1000001                                                                                                                                                  
                                            1000001                                                                                                                                                  
                                            1000001                                                                                                                                                  
                                            1000001                                                                                                                                                  
                                            1000001                                                                                                                                                  
                                            1000001                                                                                                                                                  
                                            1000001                                                                                                                                                  
                                            1000001                                                                                                                                                  
                                            1000001                                                                                                                                                  
                                            1000001                                                                                                                                                  
                                            1000001                                                                                                                                                  
                                            1000001                                                                                                                                                  
                                            1000001                                                                                                                                                  
                                            1000001                                                                                                                                                  
                                            1000001                                                                                                                                                  
                                            1000001111111111111111111111111111111111111111111111111111111                                                                                            
                                            10000000000000000000000000000000000000000000000000000000000001                                                                                           
                                           1000000000000000000000000000000000000000000000000000000000000011                                                                                          
                                           10000000000000000000000000000000000000000000000000000000000000001                                                                                         
                                           10000000000000000000000000000000000000000000000000000000000000001                                                                                         
                                           10000000000000000000000000000000000000000000000000000000000000001                                                                                         
                                            1111111111111111111111111111111111111111111111111111111111000001                                                                                         
                                                                                                     1000001                                                                                         
                                                                                                     1000001                                                                                         
                                                                                                     1000001                                                                                         
                                                                                                     1000001                                                                                         
                                                                                                     1000001                                                                                         
                                                                                                     1000001                                                                                         
                                                                                                     1000001                                                                                         
                                                                                                     1000001                                                                                         
                                                                                                     1000001                                                                                         
                                                                                                     1000001                                                                                         
                                                                                                     1000001                                                                                         
                                                                                                     1000001                                                                                         
                                                                                                     1000001                                                                                         
                                                                                                     1000001                                                                                         
                                                                                                     100D001                                                                                         
                                                                                                     1000001                                                                                         
                                                                                                     1000001                                                                                         
                                                                                                     1000001                                                                                         
                                                                                                     1000001                                                                                         
                                                                                                      11111                                                                                          
                                                                                                                                                                                                     
                                                                                                                                                                                                     
                                                                                                                                                                                                     
                                                                                                                                                                                                     
