NO      ./graphic/NO.xpm
SO      ./graphic/SO.xpm
WE      ./graphic/WE.xpm
EA      ./graphic/EA.xpm
DO      ./graphic/DO.xpm

F 185,115,87
C 197,166,160

11111111111111111111111111111111111111111111111111111111111111111111111111111111111111111111111111111111111111111111111111111111111111
11111111111111111111111111111111111111111111111111111111111111111111111111111111111111111111111111111111111111111111111111111111111111
11111111111111111111111111111111111111111111111111111111111111111111111111111111111111111111111111111111111111111111111111111111111111
11111111111111111111111111111111111111111111111111111111111111111111111111111111111111111111111111111111111111111111111111111111111111
11111111111111111111111111111111111111111111111111111111111111111111111111111111111111111111111111111111111111111111111111111111111111
11111111111111111111111111111111111111111111111111111111111111111111111111111111111111111111111111111111111111111111111111111111111111
11111111111111111111111111111111111111111111111111111111111111111111111111111111111111111111111111111111111111111111111111111111111111
11111111111111111111111111111111111111111111111111111111111111111111111111111111111111111111111111111111111111111111111111111111111111
11111111111111111111111111111111111111111111111111111111111111111111111111111111111111111111111111111111111111111111111111111111111111
11111111111111111111111111111111111111111111111111111111111111111111111111111111111111111111111111111111111111111111111111111111111111
11111111111111111111111111111111000000011111111111111111111111111111111111111111111111111111111111111111111111111111111111111111111111
11111111111111111111111111111111000000011111111111111111111111111111111111111111111111111111111111111111111111111111111111111111111111
11111111111111111111111111111111000000011111111111111111111111111111111111111111111111111111111111111111111111111111111111111111111111
11111111111111111111111111111111000000011111111111111111111111111111111111111111111111111111111111111111111111111111111111111111111111
11111111111100000000000000000000000000011111111111111111111111111111111111111111111111111111111111111111111111111111111111111111111111
11111111111101111111111111111111000000011111111111111111111111111111111111111111111111111111111111111111111111111111111111111111111111
11111111111101111111111111111111000000011111111111111111111111111111111111111111111111111111111111111111111111111111111111111111111111
11111111111101111111111111111111000000011111111111111111111111111111111111111111111111111111111111111111111111111111111111111111111111
11111111111101111111111111111111000001011111111111111111111111111111111111111111111111111111111111111111111111111111111111111111111111
11111111111101111111111111111111111011111111111111111111111111111111111111111111111111111111111111111111111111111111111111111111111111
11111111111101111111111111111111111011110000000000011111111111111111111111111111111111111111111111111111111111111111111111111111111111
11111111111101111111111111111111111011110000000000011111111111111111111111111111111111111111111111111111111111111111111111111111111111
111111111111011111111111111111111110111100000D0000011111111111111111111111111111111111111111111111111111111111111111111111111111111111
11111111111101111111111111111111111011110000000000011111111111111111111111111111111111111111111111111111111111111111111111111111111111
11111111111101111111111111111111111011110000000000011111111111111111111111111111111111111111111111111111111111111111111111111111111111
11111111111101111111111111111111111011110000000000011111111111111111111111111111111111111111111111111111111111111111111111111111111111
11111111111101111111111111111111111011111111101111111111111111111111111111111111111111111111111111111111111111111111111111111111111111
11111111111101111111111111111111111011111111101111111111111111111111111111111111111111111111111111111111111111111111111111111111111111
11111111111101111111111111111111111011111111101111111111111111111111111111111111111111111111111111111111111111111111111111111100000001
11111111111101111111111111111111111011111111101111111111111111111111111111111111111111111111111111111111111111111111111111111100000001
11111111111101111111111111111111111011111111101111111111111111111111111111111111111111111111111111111111111111111111111111111100000001
11111111111101111111111111111111111011111111101111111111111111111111111111111111111111111111111111111111111111111111111111111100000001
11111111111101111111111111111111111011111111101111111111111111111111111111111111111111111111111000000000000000000000000000000000000001
11111111111101111111111111111111111011111111101111111111111111111111111111111111111111111111111011111111111111111111111111111100000001
11111111111101111111111111111111111011111111101111111111111111111111111111111111111111111111111011111111111111111111111111111100000001
11111111111101111111111111111111111011111111000001111111111111111111111111111111111111111111111011111111111111111111111111111100000001
11111111111101111111111111111111111011111111000001111111111111111111111111111111111111111111111011111111111111111111111111111100000001
11111111111101111111111111111111111011111111000001111111111111111111111111111111111111111111111011111111111111111111111111111111101111
11111111111101111111111111111111111000000000000001111111111111111111111111111111111111111111111011111111111111111111111111111111101111
11111111111101111111111111111111111111111111000011111111111111111111111111111111111111111111111011111111111111111111111111111111101111
11111111111101111111111111111111111111111111000001111111111111111111111111111111111111111111111011111111111111111111111111111111101111
11111111111101111111111111111111111111111111000001111111111111111111111111111111111111111111111011111111111111111111111111111111101111
11111111111101111111111111111111111111111111000001111111111111111111111111111111111111111111111011111111111111111111111111111111101111
11111111111101111111111111111111111111111111100111111111111111111111111111111111111111111111111011111111111111111111111111111111101111
11111111111101111111111111111111111111111111100111111111111111111111111111111111111111111111111011111111111111111111111111111111101111
11111111111101111111111111111111111111111111100111111111111111111111111111111111111111111111111011111111111111111111111111111111101111
11111111111101111111111111111111111111111111100111111111111111111111111111111111111111111111111011111111111111111111111111111111101111
11111111111101111111111111111111111111111111100111111111111111111111111111111111111111111111111011111111111111111111111111111111101111
11111111111101111111111111111111111111111111100111111111111111111111111111111111111111111110010000001111111111111111111111111111101111
11111111100000001111111111111111111111111111100111111111111111111111111111111111111111111110000000001111111111111111111111111111101111
11111111100000001111111111111111111111111111100000000000000000000000000000000000000000000000000000001111111111111111111111111111101111
11111111100000000100000000000000000000000000001111111111111111111111111111111111111111111110000000001111111111111111111111111111101111
11111111100000001111111111111111111111111111111111111111111111111111111111111111111111111110000000001111111111111111111111111111101111
11111111100000001111111111111111111111111111111111111111111111111111111111111111111111111110000000001111111111111111111111111111101111
11111111100000001111111111111111111111111111111111111111111111111111111111111111111111111111111111111111111111111111111111111111101111
11111111111111111111111111111111111111111111111111111111111111111111111111111111111111111111111111111111111111111111111111111111101111
11111111111111111111111111111111111111111100000111111111111111111111111111111111111111111111111111111111111111111111111111111111101111
11111111111111111111111111111111111111111100000111111111111111111111111111111111111111111111111111111111111111111111111111111111101111
11111111111111111111111111111111111111111100000000000000000000000000000000000000000000000000000000000000000000000000000000000000001111
11111111111111111111111111111111111111111100000111111111111111111111111111111111111111111111111111111111111111111111111000000111111111
11111111111111111111111111111111111111111100000111111111111111111111111111111111111111111111111111111111111111111111111000000111111111
11111111111111111111111111111111111111111111011111111111111111111111111111111111111111111111111111111111111111111111111000000111111111
1111111111111111111111111111111111111111111100000000000000000000000000000000000000000000000000000000000000000000000000000E000111111111
11111111111111111111111111111111111111111111111111111111111111111111111111111111111111111111111111111111111111111111111000000111111111
11111111111111111111111111111111111111111111111111111111111111111111111111111111111111111111111111111111111111111111111000000111111111
11111111111111111111111111111111111111111111111111111111111111111111111111111111111111111111111111111111111111111111111000000111111111
11111111111111111111111111111111111111111111111111111111111111111111111111111111111111111111111111111111111111111111111111111111111111
11111111111111111111111111111111111111111111111111111111111111111111111111111111111111111111111111111111111111111111111111111111111111
11111111111111111111111111111111111111111111111111111111111111111111111111111111111111111111111111111111111111111111111111111111111111
11111111111111111111111111111111111111111111111111111111111111111111111111111111111111111111111111111111111111111111111111111111111111
11111111111111111111111111111111111111111111111111111111111111111111111111111111111111111111111111111111111111111111111111111111111111
11111111111111111111111111111111111111111111111111111111111111111111111111111111111111111111111111111111111111111111111111111111111111
11111111111111111111111111111111111111111111111111111111111111111111111111111111111111111111111111111111111111111111111111111111111111
11111111111111111111111111111111111111111111111111111111111111111111111111111111111111111111111111111111111111111111111111111111111111
11111111111111111111111111111111111111111111111111111111111111111111111111111111111111111111111111111111111111111111111111111111111111
11111111111111111111111111111111111111111111111111111111111111111111111111111111111111111111111111111111111111111111111111111111111111
11111111111111111111111111111111111111111111111111111111111111111111111111111111111111111111111111111111111111111111111111111111111111
11111111111111111111111111111111111111111111111111111111111111111111111111111111111111111111111111111111111111111111111111111111111111
11111111111111111111111111111111111111111111111111111111111111111111111111111111111111111111111111111111111111111111111111111111111111
11111111111111111111111111111111111111111111111111111111111111111111111111111111111111111111111111111111111111111111111111111111111111
11111111111111111111111111111111111111111111111111111111111111111111111111111111111111111111111111111111111111111111111111111111111111
11111111111111111111111111111111111111111111111111111111111111111111111111111111111111111111111111111111111111111111111111111111111111
11111111111111111111111111111111111111111111111111111111111111111111111111111111111111111111111111111111111111111111111111111111111111
11111111111111111111111111111111111111111111111111111111111111111111111111111111111111111111111111111111111111111111111111111111111111
11111111111111111111111111111111111111111111111111111111111111111111111111111111111111111111111111111111111111111111111111111111111111
11111111111111111111111111111111111111111111111111111111111111111111111111111111111111111111111111111111111111111111111111111111111111
11111111111111111111111111111111111111111111111111111111111111111111111111111111111111111111111111111111111111111111111111111111111111
11111111111111111111111111111111111111111111111111111111111111111111111111111111111111111111111111111111111111111111111111111111111111
