NO      ./graphic/NO.xpm
SO      ./graphic/SO.xpm
WE      ./graphic/WE.xpm
EA      ./graphic/EA.xpm
DO      ./graphic/DO.xpm

F 81,99,132
C 197,214,183

                                                                                                                                             
                                                                                                                                             
                                                                                                                                             
                                                                                                                                             
                                                                                                                                             
                                                                                                                                             
                                                                                                                                             
                                                                                                                                             
                                                                                                                                             
                                                                                                                                             
                                                                                                                                             
                         11111111111111111111111111111111111111111111111111111111111111111111111111111111111111111                           
                        1000000000000000000000000000000000000000000000000000000000000000000000000000000000000000001                          
                        10000000000000000000000000000000000000000000000000000000000000000000000000000000000000000011                         
                        100000000000000000000000000000000000000000000000000000000000000000000000000000000000000000001                        
                        100000000000000000000000000000000000000000000000000000000000000000000000000000000000000000001                        
                        100000000000000000000000000000000000000000000000000000000000000000000000000000000000000000001                        
                         11000001111111111111111111111111111111111111111111111111111111111111111111111111111111000001                        
                          1000001                                                                             1000001                        
                          1000001                                                                             1000001                        
                          1000001                                                                             1000001                        
                          1000001                                                                             1000001                        
                          1000001                                                                             1000001                        
                          1000001                                                                             1000001                        
                          1000001                                                                             1000001                        
                          1000001                                                                             1000001                        
                          1000001                                                                             1000001                        
                          1000001                                                                             1000001                        
                          1000001                                                                             1000001                        
                          1000001                                                                             1000001                        
                          1000001                                                                             1000001                        
                          1000001                                                                             1000001                        
                          1000001                                                                             1000001                        
                          1000001                                                                             1000001                        
                          1000001                                                                             1000001                        
                          1000001                                                                             1000001                        
                          1000001                                                                             1000001                        
                          1000001                                                                             1000001                        
                          1000001                                                                             1000001                        
                          1000001                                11111111111                                  1000001                        
                          1000001                               1000000000001                                 1000001                        
                          1000001                               1000000000001                                 1000001                        
                          1000001                               100000E000001                                 1000001                        
                          1000001                               1000000000001                                 1000001                        
                          1000001                               1000000000001                                 1000001                        
                          1000001                               1000000000001                                 1000001                        
                          1000001                                10000011111                                  1000001                        
                          1000001                          1111111000001                                      1000001                        
                          1000001111111111111111111111111110000000000001                                      1000001                        
                          1000000000000000000000000000000000000000000001                                      1000001                        
                          1000000000000000000000000000000000000000000001                                      1000001                        
                          1000000000000000000000000000000000000000000001                                      1000001                        
                           110000000000000000000000000000000000000000001                                      1000001                        
                            10000000000000000000000000000000000000000001                                      1000001                        
                             1111111111111111111111111111110000000000001                                      1000001                        
                                                          10000000000001                                      1000001                        
                                                           1000001000001                                      1000001                        
                                                           1000001000001                                      1000001                        
                                                           1000001000001                                      1000001                        
                                                           1000001000001                                      1000001                        
                                                           100000100000111111111111111111111111111111111111111100000111111111                
                                                           1000000000000000000000000000000000000000000000000000000000000000001               
                                                           1000000000000000000000000000000000000000000000000000000000000000001               
                                                           1000000000000000000000000000000000000000000000000000000000000000001               
                                                            110000000000000000000000000000000000000000000000000000000000000001               
                                                             10000000000000000000000000000000000000000000000000000000000000001               
                                                              1111000001111111111111111111111111111111111111111000001111000001               
                                                                 1000001                                      1000001  1000001               
                                                                 1000001                                      1000001  1000001               
                                                                 1000001                                      1000001  1000001               
                                                                 1000001                                      1000001  1000001               
                                                                 1000001                                      1000001  1000001               
                                                                 1000001                                      1000001  1000001               
                                                                 1000001                                      1000001  1000001               
                                                                 1000001                                      1000001  1000001               
                                                                 1000001                                      1000001  1000001               
                                                                 1000001                                      1000001  1000001               
                                                                 1000001                                      1000001  1000001               
                                                                 1000001                                      1000001  1000001               
                                                                 1000001                                      1000001  1000001               
                                                                 1000001                                      1000001  1000001               
                                                                 1000001                                      1000001  1000001               
                                                                 1000001                                      1000001  1000001               
                                                                 1000001                                      1000001  1000001               
                                1111                             1000001                                      1000001  1000001               
                               100001                            1000001                                      1000001  1000001               
                              100D001                            1000001                                      1000001  1000001               
                              1000001                            1000001                                      1000001  1000001               
                              1000001                            1000001                                      1000001  1000001               
                              1000001                            1000001                                      1000001  1000001               
                              1000001                            1000001                                      1000001  1000001               
                              1000001                            1000001                                      1000001  1000001               
                              1000001                            1000001                                      1000001  1000001               
                              1000001                            1000001                                      1000001  1000001               
                              1000001                            1000001                                      1000001  1000001               
                              1000001                            1000001                                      1000001  1000001               
                              1000001                            1000001                                      1000001  1000001               
                              1000001                            1000001                                      1000001  1000001   1111111     
                              10000011111111111111111111111111111100000111111111111111111111111111111111111111100000111100000111100000001    
                              10000000000000000000000000000000000000000000000000000000000000000000000000000000000000000000000000000000001    
                              10000000000000000000000000000000000000000000000000000000000000000000000000000000000000000000000000000000001    
                              10000000000000000000000000000000000000000000000000000000000000000000000000000000000000000000000000000000001    
                               1100000000000000000000000000000000000000000000000000000000000000000000000000000000000000000000000000000001    
                                100000000000000000000000000000000000000000000000000000000000000000000000000000000000000000000000000000001    
                                 11111111111111111111111111111111100000000000000000000000000000000000000000000000000000000000000000000001    
                                                                  11111111111111111111111111111111111111111100000000000111111111100000001    
                                                                                                            11111111111          1111111     
                                                                                                                                             
                                                                                                                                             
                                                                                                                                             
                                                                                                                                             
                                                                                                                                             
