NO      ./graphic/NO.xpm
SO      ./graphic/SO.xpm
WE      ./graphic/WE.xpm
EA      ./graphic/EA.xpm
DO      ./graphic/DO.xpm

F 191,113,187
C 198,205,240

111111111111111111111111111111111111111111111111111111111111111111111111111111
111111100000000000111111111111111111111111111111111111111111111111111111111111
111111100000000000111111111111111111111111111111111111111111111111111111111111
111111100000000000111111111111111111111111111111111111111111111111111111111111
111111100000D00000111111111111111111111111111111111111111111111111111111111111
111110000000010000111111111111111111111111111111111111111111111111111111111111
111110000000000000111111111111111111111111111111111111111111111111111111111111
111110000000000000111111111111111111111111111111111111111111111111111111111111
111110000000000111111111111111111111111111111111111111111111111111111111111111
111111111010011111111111111111111111111111111111111111111111111111111111111111
111111111010011111111111111111111111111111111111111111111111111111111111111111
111111110000000011111111111111111111111111111111111111111111111111111111111111
111111110000000011111111111111111111111111111111111111111111111111111111111111
111111110000000011111111111111111111111111111111111111111111111111111111111111
111111110000000011111111111111111111111111111111111111111111111111111111111111
111111100000000011111111111111111111111111111111111111111111111111111111111111
111111100000000011111111111111111111111111111111111111111111111111111111111111
111111100000000011111111111111111111111111111111111111111111111111111111111111
111111100001000011111111111111111111111111111111111111111111111111111111111111
111111000000000011111111111111111111111111111111111111111111111111111111111111
111111000011011111111111111111111111111111111111111111111111111111111111111111
111111000011011111111111111111111111111111111111111111111111111111111111111111
111111000000001111111111111111111111111111111111111111111100001111111111111111
111111000000000000000100000000000000000000000000000000000000001111111111111111
111111000011001111111111111111111111111111111111111111111100001111111111111111
111111000011001111111111111111111111111111111111111111111100001111111111111111
111111000011001111111111111111111111111111111111111111111110111111111111111111
111111111111001111111111111111111111111111111111111111111110111111111111111111
111111111111001111111111111111111111111111111111111111111110111111111111111111
111111111110000000001111111111111111111111111111111111111110111111111111111111
111111111110000000001111111111111111111111111111111111111110111111111111111111
111111111110000000000000000000000000000000000000000000000000111111111111111111
111111111110000000001111111111111111111111111111111111111111111111111111111111
1111111111100000S0001111111111111111111111111111111111111111111111111111111111
111111111110000000001111111111111111111111111111111111111111111111111111111111
111111111110000000011111111111111111111111111111111111111111111111111111111111
111111111110000000011111111111111111111111111111111111111111111111111111111111
111111111111111111111111111111111111111111111111111111111111111111111111111111
111111111111111111111111111111111111111111111111111111111111111111111111111111
