NO      ./graphic/NO.xpm
SO      ./graphic/SO.xpm
WE      ./graphic/WE.xpm
EA      ./graphic/EA.xpm
DO      ./graphic/DO.xpm

F 89,159,140
C 180,226,195

                                                                                                          1111111111      11111111                                  
                  11111111111111111111111111111111111111111111111111111111111111111111111111111111111111110000000000111111000000001                                 
                 100000000000000000000000000000000000000000000000000000000000000000000000000000000000000000000000000000000000000001                                 
                1100000000000000000000000000000000000000000000000000000000000000000000000000000000000000000000000000000000000000001                                 
               10000000000000000000000000000000000000000000000000000000000000000000000000000000000000000000000000000000000000W00001                                 
               10000000000000000000000000000000000000000000000000000000000000000000000000000000000000000000000000000000000000000001                                 
               10000000000000000000000000000000000000000000000000000000000000000000000000000000000000000000000000000000000000000001                                 
               10000011111111111111111111111111111111111111111111111111111111111111111111111111111111111110000000000111111000000001                    1111         
              1100000111                          1111111111111111111111111111111111111111111111000000000001111111111111111111111111111111111111111111100001        
             100000000001111111111111111111111111100000000000000000000000000000000000000000000000000000000000000000000000000000000000000000000000000000000011       
             1000000000000000000000000000000000000000000000000000000000000000000000000000000000000000000000000000000000000000000000000000000000000000000000001      
             1000000000000000000000000000000000000000000000000000000000000000000000000000000000000000000000000000000000000000000000000000000000000000000000001      
             1000000000000000000000000000000000000000000000000000000000000000000000000000000000000000000000000000000000000000000000000000000000000000000000001      
             1000000000000000000000000000000000000000000000000000000000000000000000000000000000000000000000000000000000000000000000000000000000000000000000001      
             10000000000000000000000000000000000000000000000000000000000000000000000000000000000000000000000000000000000000000000000000000000000000000000D0001      
             1000000000011111111111111111111111110000000000000000000000000000000000000000000000000000000000000000000000000000000000000000000000000000000000001      
              1111111111                         1111111111111111111111111111111111111111111100000000000000000000000000000000000000000000000000000000000000001      
                                                                                            100000000000000000000000000000000000000000000000000000000000000001      
                                                                                            100000000000000000000000000000000000000000000000000000000000000001      
                                                                                             1111111111111111111111111111111111111111111111111111111111111111       
                                                                                                                                                                    
