NO      ./graphic/NO.xpm
SO      ./graphic/SO.xpm
WE      ./graphic/WE.xpm
EA      ./graphic/EA.xpm
DO      ./graphic/DO.xpm

F 66,119,98
C 246,233,248

                                                                                                                                                       
                                                                                                                                                       
                                                                                                                                                       
                                                                                                                                                       
                                                                                                                                                       
                                                                                                                                                       
                                                                                                                                                       
                                                                                                                                                       
                                                                                                                                                       
                                                                                                                                                       
                                                                                                                                                       
                                                                                    1111111                                                            
                                                                                   10000000111111111111111111111111111111111111                        
                                                                                   100000000000000000000000000000000000000000001                       
                                                                                   1000000000000000000000000000000000000000000011                      
                                                                                   10000000000000000000000000000000000000000000001                     
                                                                                   10000000000000000000000000000000000000000000001                     
                                                                                   10000000000000000000000000000000000000000000001                     
                                                                                   10000000111111111111111111111111111111111000001                     
                                                                                    1000001                                1000001                     
                                                                                    1000001                                1000001                     
                                                                                    1000001                                1000001                     
                                                                                    1000001                                1000001                     
                                                                                    1000001                                1000001                     
                                                                                    1000001                                1000001                     
                                                                                    1000001                                1000001                     
                                                                                    1000001                                1000001                     
                                                                                    1000001                                1000001                     
                                                                                    1000001                                1000001                     
                                                                                    1000001                                1000001                     
                                                                                    1000001                                1000001                     
                                                                                    1000001                                1000001                     
                                                                                    1000001                                1000001                     
                                                                                    1000001                                1000001                     
                                                                                    1000001                                1000001                     
                                                                                    1000001                                1000001                     
                                                                                    1000001                                1000001                     
                                                                                    1000001                                1000001                     
                                                                                    1000001                                1000001                     
                                                                                    1000001                                1000001                     
                                                                                    1000001                                1000001                     
                                                                                    1000001                                1000001                     
                                                                                    1000001                                1000001                     
                                                                                    1000001                                1000001                     
                                                                                    1000001                                100000111111                
                                                   1111111111111111111111111111111111000001111111111111111111111111111111111000000000001               
                                                  10000000000000000000000000000000000000000000000000000000000000000000000000000000000001               
                                                 110000000000000000000000000000000000000000000000000000000000000000000000000000000000001               
                                                1000000000000000000000000000000000000000000000000000000000000000000000000000000000000001               
                                                1000000000000000000000000000000000000000000000000000000000000000000000000000000000000001               
                                                1000000000000000000000000000000000000000000000000000000000000000000000000000000000000001               
                                                1000001111111111111111111111111111111000001111111111111111111111111111111111000000000001               
                                                1000001                             1000001                                100000000011                
                                                1000001                             1000001                                10000000001                 
                                                1000001                             1000001                                10000000001                 
                                                1000001                             1000001                                10000000001                 
                                                1000001                             1000001                                10000000001                 
                                                1000001                             1000001                                10000000001                 
                                                1000001                             1000001                                10000000001                 
                                                1000001                             1000001       111111111111111111111111110000000001                 
                                                1000001                             1000001      1000000000000000000000000000000000001                 
                                                1000001                             1000001      1000000000000000000000000000000000001                 
                                                1000001                             1000001      1000000000000000000000000000000000001                 
                                                1000001                             10000011111  100000000000000000000000000000000011                  
                                                1000001                             100000000001 10000000000000000000000000000000001                   
                                                1000001                             100000000001  1100000111111111111111110000D00001                   
                                                1000001                             100000000001   1000001               10000000001                   
                                                1000001                             100000000001   1000001               10000000001                   
                                                1000001                             100000000001   1000001               10000000001                   
                                                1000001                              10000000001   1000001                111111111                    
                                                1000001                              10000000001   1000001                                             
                                                1000001                              10000000001   1000001                                             
                                                10000011                             10000000001   1000001                                             
                                                10000000111111111111111111111111111111110000011    1000001                                             
                                                1000000000000000000000000000000000000000000001     1000001                                             
                                                1000000000000000000000000000000000000000000001     1000001                                             
                                                1000000000000000000000000000000000000000000001     1000001                                             
                                                100000000000000000000000000000000000000000011      1000001                                             
                                                10000000000000000000000000000000000000000001       1000001                                             
                                               11000000011111111111111111111111111111111111        1000001                                             
                                              10000000001                                          1000001                                             
                                              10000000001                                          1000001                                             
                                              10000000001                                          1000001                                             
                                              10000000001                                          1000001                                             
                                              10000000001                                          1000001                                             
                                               111111111                                           1000001                                             
                                                                                                   1000001                                             
                                                                                                   1000001                                             
                                                                                                   1000001                                             
                                                                                                   1000001                                             
                                            11111111111111111111111111111111111111111111111111111111000001                                             
                                           100000000000000000000000000000000000000000000000000000000000001                                             
                                           100000000000000000000000000000000000000000000000000000000000001                                             
                                           1000W0000000000000000000000000000000000000000000000000000000001                                             
                                           10000000000000000000000000000000000000000000000000000000000011                                              
                                           1000000000000000000000000000000000000000000000000000000000001                                               
                                           100000000111111111111111111111111111111111111111111111111111                                                
                                            11111111                                                                                                   
                                                                                                                                                       
                                                                                                                                                       
                                                                                                                                                       
                                                                                                                                                       
                                                                                                                                                       
                                                                                                                                                       
                                                                                                                                                       
                                                                                                                                                       
                                                                                                                                                       
