NO      ./graphic/NO.xpm
SO      ./graphic/SO.xpm
WE      ./graphic/WE.xpm
EA      ./graphic/EA.xpm
DO      ./graphic/DO.xpm

F 76,81,74
C 154,241,156

111111111111111111111111111111111111111111111111111111111111111111111111111111111111111111111111111111111111111111111111111111111111111111111111111111111111111111111
111111111111111111111111111111111111111111111111111111111111111111111111111111111111111111111111111111111111111111111111111111111111111111111111111000001111111111111
111111111111111111111111111111111111111111111111111111111111111111111111111111111111111111111111111111111111111111111111111111111111111111111111111000001111111111111
111111111111111111111111111111111111111111111111111111111111111111111111111111111111111111111111111111111111111111111111111111111111111111111111111000001111111111111
111111111111111111111111111111111111111111111111111111111111111111111111111111111111111111111111111111111111111111111111111111111111111111111111111010001111111111111
111111111111000000000011111111111111111111111111111111111111111111111111111111111111111111111111111111111111111111111111110000000000000000000000000000001111111111111
111111111111000000000011111111111111111111111111111111111111111111111111111111111111111111111111111111111111111111111111110111111111111111111111111000001111111111111
111000000000001000000011111111111111111111111111111111111111111111111111111111111111111111111111111111111111111111111111110111111111111111111111111000001111111111111
111011111111000000000011111111111111111111111111111111111111111111111111111111111111111111111111111111111111111111111111110111111111111111111111111000001111111111111
111011111111000000000011111111111111111111111111111111111111111111111111111111111111111111111111111111111111111111111111110111111111111111111111111000001111111111111
111011111111000000000011111111111111111111111111111111111111111111111111111111111111111111111111111111111111111111111111110111111111111111111111111110111111111111111
111011111111111101111111111111111111111111111111111111111111111111111111111111111111111111111111111111111111111111111111110111111111111111111111111110111111111111111
111011111111111101111111111111111111111111111111111111111111111111111111111111111111111111111111111111111111111111111111110111111111111111111111111110111111111111111
111011111111111101111111111111111111111111111111111111111111111111111111111111111111111111111111111111111111111111111111110111111111111111111111111110111111111111111
111011111111111101111111111111111111111111111111111111111111111111111111111111111111111111111111111111111111111111111111110111111111111111111111111110111111111111111
111011111111111101111111111111111111111111111111111111111111111111111111111111111111111111111111111111111111111111111111110111111111111111111111111110111111111111111
111011111111111101111111111111111111111111111111111111111111111111111111111111111111111111111111111111111111111111111111110111111111111111111111111110111111111111111
111011111111111101111111111111111111111111111111111111111111111111111111111111111111111111111111111111111111111111111111110111111111111111111111111110111111111111111
111011111111111101111111111111111111111111111111111111111111111111111111111111111111111111111111111111111111111111111111110111111111111111111111111110111111111111111
111011111111111101111111111111111111111111111111111111111111111111111111111111111111111111111111111111111111111111111111110111111111111111111111111110111111111111111
111011111111111101111111111111111111111111111111111111111111111111111111111111111111111111111111111111111111111111111111110111111111111111111111111110111111111111111
111011111111111101111111111111111111111111111111111111111111111111111111111111111111111111111111111111111111111111111111110111111111111111111111111110111111111111111
111011111111111101111111111111111111111111111111111111111111111111111111111111111111111111111111111111111111111111111111110111111111111111111111111110111111111111111
111011111111111101111111111111111111111111111111111111111111111111111111111111111111111111111111111111111111111111111111110111111111111111111111111110111111111111111
111011111111111101111111111111111111111111111111111111111111111111111111111111111111111111111111111111111111111111111111110111111111111111111111111110111111111111111
111011111111111101111111111111111111111111111111111111111111111111111111111111111111111111111111111111111111111111111111110111111111111111111111111110111111111111111
111011111111111101111111111111111111111111111111111111111111111111111111111111111111111111111111111111111111111111111111110111111111111111111111111110111111111111111
111011111111111101111111111111111111111111111111111111111111111111111111111111111111111111111111111111111111111111111111110111111111111111111111111110111111111111111
111011111111111101111111111111111111111111111111111111111111111111111111111111111111111111111111111111111111111111111111110111111111111111111111111110111111111111111
111011111111111101111111111111111111111111111111111111111111111111111111111111111111111111111111111111111111111111111111110111111111111111111111111110111111111111111
100000011111111100000111111111111111111111111111111111111111111111111111111111111111111111111111111111111111111111111111110111111111111111111111111110111111111111111
100000011111111100000111111111111111111111111111111111111111111111111111111111111111111111111111111111111111111111111111110111111111111111111111111110111111111111111
100000000000000000000000001000000000000000000000000000000000000000000000000000000000000000000000000000000000000000000000000000000011111111111111111110111111111111111
100000011111111100000111111111111111111111111111111111111111111111111111111111111111111111111111111111111111111111111111110111111011111111111111111110111111111111111
100000011111111100000111111111111111111111111111111111111111111111111111111111111111111111111111111111111111111111111111110111111011111111111111111110111111111111111
111111111111111111011111111111111111111111111111111111111111111111111111111111111111111111111111111111111111111111111111110111111011111111111111111110111111111111111
111111111111111111011111111111111111111111111111111111111111111111111111111111111111111111111111111111111111111111111111110111111011111111111111111110111111111111111
111111111111111111011111111111111111111111111111111111111111111111111111111111111111111111111111111111111111111111111111110111111011111111111111111110111111111111111
111111111111111111011111111111111111111111111111111111111111111111111111111111111111111111111111111111111111111111111111110111111011111111111111111110111111111111111
111111111111111111011111111111111111111111111111111111111111111111111111111111111111111111111111111111111111111111111111110111111011111111111111111110111111111111111
111111111111111111011111111111111111111111111111111111111111111111111111111111111111111111111111111111111111111111111111110111111011111111111111111110111111111111111
111111111110000000111111111111111111111111111111111111111111111111111111111111111111111111111111111111111111111111111111110111111011111111111111111110111111111111111
111111111110000000011111111111111111111111111111111111111111111111111111111111111111111111111111111111111111111111111111110111111011111111111111111110111111111111111
111111111110000000011111111111111111111111111111111111111111111111111111111111111111111111111111111111111111111111111111110111111011111111111111111110111111111111111
111111111110000000000000000000000000000000000000000000000000000000000000000000000000000000000000000000000000000000000000000000000000000000000000000000111111111111111
111111111110000000011111111111111111111111111111111111111111111111111111111111111111111111111111111111111111111111111111110111111011111111111111111111111111111111111
111111111110000000011111111111111111111111111111111111111111111111111111111111111111111111111111111111111111111111111111110111111011111111111111111111111111111111111
111111111110000000011111111111111111111111111111111111111111111111111111111111111111111111111111111111111111111111111111110111111011111111111111111111111111111111111
111111111111110111011111111111111111111111111111111111111111111111111111111111111111111111111111111111111111111111111111110111111011111111111111111111111111111111111
111111111111110111011111111111111111111111111111111111111111111111111111111111111111111111111111111111111111111111111111110111110000111111111111111111111111111111111
111111111111110111011111111111111111111111111111111111111111111111111111111111111111111111111111111111111111111111111111110111110000111111111111111111111111111111111
111111111111110111011111111111111111111111111111111111111111111111111111111111111111111111111111111111111111111111111111110111110000111111111111111111111111111111111
111111111111110000000000000000000000000000000000000000000000000000000000000000000000000000000000000000000000000000000000000000000000111111111111111111111111111111111
111111111111111111011111111111111111111111111111111111111111111111111111111111111111111111111111111111111111111111111111110111110000111111111111111111111111111111111
111111111111111111011111111111111111111111111111111111111111111111111111111111111111111111111111111111111111111111111111110111110000111111111111111111111111111111111
111111111111111111011111111111111111111111111111111111111111111111111111111111111111111111111111111111111111111111111111110111110000111111111111111111111111111111111
111111111111111111011111111111111111111111111111111111111111111111111111111111111111111111111111111111111111111111111111110111111111111111111111111111111111111111111
111111111111111111011111111111111111111111111111111111111111111111111111111111111111111111111111111111111111111111111111110111111111111111111111111111111111111111111
111111111111111111011111111111111111111111111111111111111111111111111111111111111111111111111111111111111111111111111111110111111111111111111111111111111111111111111
111111111111111111011111111111111111111111111111111111111111111111111111111111111111111111111111111111111111111111111111110111111111111111111111111111111111111111111
111111111111111111011111111111111111111111111111111111111111111111111111111111111111111111111111111111111111111111111111110111111111111111111111111111111111111111111
111111111111111111011111111111111111111111111111111111111111111111111111111111111111111111111111111111111111111111111111110111111111111111111111111111111111111111111
111111111111111111011111111111111111111111111111111111111111111111111111111111111111111111111111111111111111111111111111110111111111111111111111111111111111111111111
111111111111111111011111111111111111111111111111111111111111111111111111111111111111111111111111111111111111111111111111110111111111111111111111111111111111111111111
111111111111111111011111111111111111111111111111111111111111111111111111111111111111111111111111111111111111111111111100000000011111111111111111111111111111111111111
111111111111111111011111111111111111111111111111111111111111111111111111111111111111111111111111111111111111111111111100000000011111111111111111111111111111111111111
11111111111111111101111111111111111111111111111111111111111111111111111111111111111111111111111111111111111111111111110000D000011111111111111111111111111111111111111
111111111111111111011111111111111111111111111111111111111111111111111111111111111111111111111111111111111111111111111100000000011111111111111111111111111111111111111
111111111111111111011111111111111111111111111111111111111111111111111111111111111111111111111111111111111111111111111100000000011111111111111111111111111111111111111
111111111111111111011111111111111111111111111111111111111111111111111111111111111111111111111111111111111111111111111100000000011111111111111111111111111111111111111
111111111111111111011111111111111111111111111111111111111111111111111111111111111111111111111111111000000001111111111111111111111111111111111111111111111111111111111
111111111111111111011111111111111111111111111111111111111111111111111111111111111111111111111111111000000001111111111111111111111111111111111111111111111111111111111
111111111111111111000000000000000000000000000000000000000000000000000000000000000000000000000000000000W00001111111111111111111111111111111111111111111111111111111111
111111111111111111111111111111111111111111111111111111111111111111111111111111111111111111111111111000000001111111111111111111111111111111111111111111111111111111111
111111111111111111111111111111111111111111111111111111111111111111111111111111111111111111111111111000000001111111111111111111111111111111111111111111111111111111111
111111111111111111111111111111111111111111111111111111111111111111111111111111111111111111111111111111111111111111111111111111111111111111111111111111111111111111111
111111111111111111111111111111111111111111111111111111111111111111111111111111111111111111111111111111111111111111111111111111111111111111111111111111111111111111111
111111111111111111111111111111111111111111111111111111111111111111111111111111111111111111111111111111111111111111111111111111111111111111111111111111111111111111111
111111111111111111111111111111111111111111111111111111111111111111111111111111111111111111111111111111111111111111111111111111111111111111111111111111111111111111111
111111111111111111111111111111111111111111111111111111111111111111111111111111111111111111111111111111111111111111111111111111111111111111111111111111111111111111111
