NO      ./graphic/NO.xpm
SO      ./graphic/SO.xpm
WE      ./graphic/WE.xpm
EA      ./graphic/EA.xpm
DO      ./graphic/DO.xpm

F 85,163,160
C 161,172,140

                                                                                                                                                                                   
                                                                                                                                                                                   
                                                                                                                                                                                   
                                                                                                                                                                                   
                                                                                                                                                                                   
                                                                                                                                                                                   
                                                                                                                                                                                   
                                                                                                                                                                                   
                                                                                                                                                                                   
                                                                                                                                                                                   
                                                                                                                                                                                   
                     1111111111111111111111111111111111111111111111111111111111111111111                                                                                           
                    100000000000000000000000000000000000000000000000000000000000000000001                                                                                          
                    1000000000000000000000000000000000000000000000000000000000000000000011                                                                                         
                    10000000000000000000000000000000000000000000000000000000000000000000001                                                                                        
                    10000000000000000000000000000000000000000000000000000000000000000000001                                                                                        
                    10000000000000000000000000000000000000000000000000000000000000000000001                                                                                        
                    10000000111111111111111111111111111111111111111111111111111111111000001                                                                                        
                     1000001                                                        1000001                                                                                        
                     1000001                                                        1000001                                                                                        
                     1000001                                                        1000001                                                                                        
                     1000001                                                        1000001                                                                                        
                     1000001                                                        1000001                                                                                        
                     1000001                                                        1000001                                                                                        
                     1000001                111111                                  1000001                                                                                        
                     1000001               10000001                                 1000001                                                                                        
                     1000001               10000001                                 1000001                                                                                        
                     1000001               10000001                                 1000001                                                                                        
                     1000001               100D0001                                 1000001                                                                                        
                     1000001               10000001                                 1000001                                                                                        
                     1000001               10000001                                 1000001                                                                                        
                     1000001               10000001                                 1000001                                                                                        
                     1000001               10000001                                 1000001                                                                                        
                     1000001               1000001                                  1000001                                                                                        
                     1000001               1000001                                  1000001                                                                                        
                     1000001               1000001                                  1000001                                                                                        
                     1000001               1000001                                  1000001                                                                                        
                     1000001               1000001                                  1000001                                                                                        
                     1000001               1000001                                  1000001                                                                                        
                   111000001111111111111111100000111111111111111111111111111111111111000001111111111111111111111111111111111                                                       
         1111111  100000000000000000000000000000000000000000000000000000000000000000000000000000000000000000000000000000000011                                                     
        10000000111000000000000000000000000000000000000000000000000000000000000000000000000000000000000000000000000000000000001                                                    
        10000000000000000000000000000000000000000000000000000000000000000000000000000000000000000000000000000000000000000000001111                                                 
        100000000000000000000000000000000000000000000000000000000000000000000000000000000000000000000000000000000000000000000000001                                                
        1000S0000000000000000000000000000000000000000000000000000000000000000000000000000000000000000000000000000000000000000000001                                                
        100000000000000000000000000000000000000000000000000000111111111111111111111110000011111111111111111111111111111110000000001                                                
        1000000000000000000000000000000000000000000000000000001                     1000001                             10000000001                                                
        1000000010000000000111111111111111110000011111111000001                     1000001                              1100000001                                                
         1111111100000000001               1000001      1000001                     1000001                               100000001                                                
                100000000001               1000001      1000001                     1000001                               100000001                                                
                100000000001               1000001      1000001                     1000001                               100000001                                                
                100000000001               1000001      1000001                     1000001                                1000001                                                 
                100000000001               1000001      1000001                     1000001                                1000001                                                 
                100000000001               1000001      1000001                     1000001                                1000001                                                 
                100000000001               1000001      1000001                     10000011                               1000001                                                 
                100000000001               1000001      1000001                    1000000001                              1000001                                                 
                100000000001               10000011111111000001111111111111111111111000000001                              1000001                                                 
                100000000001               10000000000000000000000000000000000000000000000001                              1000001                                                 
                100000000001               10000000000000000000000000000000000000000000000001                              1000001                                                 
                100000000001               10000000000000000000000000000000000000000000000001                              1000001                                                 
                100000000001                1100000000000000000000000000000000000000000000001                              1000001                                                 
                100000000001                 100000000000000000000000000000000000000000000001                              1000001                                                 
                100000000001                  111111111110000011111111111111111111110000000011111111111111111111111111111111000001                                                 
                100000000001                            10000000000000000000000000000000000000000000000000000000000000000000000001                                                 
                100000000001                            10000000000000000000000000000000000000000000000000000000000000000000000001                                                 
                100000000001                            10000000000000000000000000000000000000000000000000000000000000000000000001                                                 
                100000000001                             100000000000000000000000000000000000000000000000000000000000000000000011                                                  
                100000000001                             10000000000000000000000000000000000000000000000000000000000000000000001                                                   
                100000000001                             1000011111111111111111111111111111111111111111111111111111111111111111                                                    
                100000000001                              1111                                                                                                                     
                100000000001                                                                                                                                                       
                100000000001                                                                                                                                                       
                100000000001                                                                                                                                                       
                100000000001                                                                                                                                                       
                100000000001                                                                                                                                                       
                100000000001                                                                                                                                                       
                100000000001                                                                                                                                                       
                100000000001                                                                                                                                                       
               1000000000001                                                                                                                                                       
               1000000000001                                                                                                                                                       
               1000000000001                                                                                                                                                       
               1000000000001                                                                                                                                                       
               1000000000001                                                                                                                                                       
               100000000011                                                                                                                                                        
               10000000001                                                                                                                                                         
               1000000011                                                                                                                                                          
               100000001                                                                                                                                                           
                1111111                                                                                                                                                            
                                                                                                                                                                                   
                                                                                                                                                                                   
                                                                                                                                                                                   
                                                                                                                                                                                   
                                                                                                                                                                                   
                                                                                                                                                                                   
                                                                                                                                                                                   
                                                                                                                                                                                   
                                                                                                                                                                                   
                                                                                                                                                                                   
                                                                                                                                                                                   
                                                                                                                                                                                   
                                                                                                                                                                                   
                                                                                                                                                                                   
                                                                                                                                                                                   
                                                                                                                                                                                   
