NO      ./graphic/NO.xpm
SO      ./graphic/SO.xpm
WE      ./graphic/WE.xpm
EA      ./graphic/EA.xpm
DO      ./graphic/DO.xpm

F 75,74,172
C 252,216,198

11111111111111111111111111111111111111111111111111111111111111111111111111111111111111111111111111111111111111111111
11111111111111111111111111111111111111111111111111111111111111111111111111111111111111111111111111111111111111111111
11111111111111111111111111111111111111111111111111111111111111111111111111111111111111111111111111111111111111111111
11111111111111111111111111111111111111111111111111111111111111111111111111111111111111111111111111111111111111111111
11111111111111111111111111111111111111111111111111111111111111111111111111111111111111111111111111111111111111111111
11111111111111111111111111111111111111111111111111111111111111111111111111111111111111111111111111111111111111111111
11111111111111111111111111111111111111111111111111111111111111111111111111111111111111111111111111111111111111111111
11111111111111111111111111111111111111111111111111111111111111111111111111111111111111111111111111111111111111111111
11111111111111111111111111111111111111111111111111111111111111111111111111111111111111111111111111111111111111111111
11111111111111111111111111111111111111111111111111111111111111111111111111111111111111111111111111111111111111111111
11111111111111111111111111111111111111111111111111111111111111111111111111111111111111111111111111111111111111111111
11111111111111111111111111111111111111111111111111111111111111111111111111111111111111111111111111111111111111111111
11111111111111111111111111111111111111111111111111111111111111111111111111111111111111111111111111111111111111111111
11111111111111111111111111111111111111111111111111111111111111111111111111111111111111111111111111111111111111111111
11111111111111111111111111111111111111111111111111111111111111111111111111111111111111111111111111111111111111111111
11111111111111111111111111111111111111111111111111111111111111111111111111111111111111111111111111111111111111111111
11111111111111111111111111111111111111111111111111111111111111111111111111111111111111111111111111111111111111111111
11111111111111111111111111111111111111111111111111111111111111111111111111111111111111111111111111111111111111111111
11111111111111111111111111111111111111111111111111111111111111111111111111111111111111111111111111111111111111111111
11111111111111111111111111111111111111111111111111111111111111111111111111111111111111111111111111111111111111111111
11111111111111111111111111111111111111111111111111111111111111111111111111111111111111111111111111111111111111111111
11111111111111111111111111111111111111111111111111111111111111111111111111111111111111111111111111111111111111111111
11111111111111111111111111111111111111111111111111111111111111111111111111111111111111111111111111111111111111111111
11111111111111111111111111111111111111111111111111111111111111111111111111111111111111111111111111111111111111111111
11111111111111111111111111111111111111111111111111111111111111111111111111111111111111111111111111111111111111111111
11111111111111111111111111111111111111111111111111111111111111111111111111111111111111111111111111111111111111111111
11111111111111111111111111111111111111111111111111111111111111111111111111111111111111111111111111111111111111111111
11111111111111111111111111111111111111111111111111111111111111111111111111111111111111111111111111111111111111111111
11111111111111111111111111111111111111111111111111111111111111111111111111111111111111111111111111111111111111111111
11111111111111111111111111111111111111111111111111111111111111111111111111111111111111111111111111111111111111111111
11111111111111111111111111111111111111111111111111111111111111111111111111111111111111111111111111111111111111111111
11111111111111111111111111111111111111111111111111111111111111111111111111111111111111111111111111111111111111111111
11111111111111111111111111111111111111111111111111111111111111111111111111111111111111111111111111111111111111111111
11111111111111111111111111111111111111111111111111111111111111111111111111111111111111111111111111111111111111111111
11111111111111111111111111111111111111111111111111111111111111111111111111111111111111111111111111111111111111111111
11111111111111111111111111111111111111111111111111111111111111111111111111111111111111111111111111111111111111111111
11111111111111111111111111111111111111111111111111111111111111111111111111111111111111111111111111111111111111111111
11111111111111111111111111111111111111111111111111111111111111111111111111111111111111111111111111111111111111111111
11111111111111111111111111111111111111111111111111111111111111111111111111111111111111111111111111111111111111111111
11111111111111111111111111111111111111111111111111111111111111111111111111111111111111111111111111111111111111111111
11111111111111111111111111111111111111111111111111111111111111111111111111111111111111111111111111111111111111111111
11111111111111111111111111111111111111111111111111111111111111111111111111111111111111111111111111111111111111111111
11111111111111111111111111111111111111111111111111111111111111111111111111111111111111111111111111111111111111111111
11111111111111111111111111111111111111111111111111111111111111111111111111111111111111111111111111111111111111111111
11111111111111111111111111111111111111111111111111111111111111111111111110000000111111111111111111111111111111111111
11111111111111111111111111111111111111111111111111111111111111111111111110000000111111111111111111111111111111111111
11111111111111111111111111111111111111111111111111111111111111111111111110000000111111111111111111111111111111111111
11111111111111111111111111111111111111111111111111111111111111111111111110000000111111111111111111111111111111111111
1111111111111111111111111111111111111111111111111111111111111111111111111000E000000111111111111111111111111111111111
11111111111111111111111111111111111111111111111111111111111111111111111110000000110111111111111111111111111111111111
11111111111111111111111111111111111111111111111111111111111111111111111110000000110111111111111111111111111111111111
11111111111111111111111111111111111111111111111111111111111111111111111110000000110111111111111111111111111111111111
11111111111111111111111111111111111111111111111111111111111111111111111110000000110111111111111111111111111111111111
11111111111111111111111111111111111111111111111111111111111111111111111111111111110111111111111111111111111111111111
11111111111111111111111111111111111111111111111111111111111111111111111111111111110111111111111111111111111111111111
11111111111111111111111111111111111111111111111111111111111111111111111111111111110111111111111111111111111111111111
11111111111111111111111111111111111111111111111111111111111111111111111111111111110111111111111111111111111111111111
11111111111111111111111111111111111111111111111111111111111111111111111111111111110111111111111111111111111111111111
11111111111111111111111111111111111111111111111111111111111111111111111111111111110111111111111111111111111111111111
11111111111111111111111111111111111111111111111111111111111111111111111111111111110111111110000000001111111111111111
11111111111111111111111111111111111110000000000000000000000000000000000000000000000000000000000000001111111111111111
11111111111111111111111111111111111110111111111111111111111111111111111111111111110111111110000000001111111111111111
11111111111111111111111111111111111110111111111111111111111111111111111111111111110111111110000000001111111111111111
11111111111111111111111111111111111110111111111111111111111111111111111111111111110111111111111011111111111111111111
11111111111111111111111111111111111110111111111111111111111111111111111111111111110111111111111011111111111111111111
11111111111111111111111111111111111110111111111111111111111111111111111111111111110111111111111011111111111111111111
11111111111111111111111111111111111110111111111111111111111111111111111111111111110111111111111011111111111111111111
11111111111111111111111111111111111110111111111111111111111111111111111111111111110111111111111011111111111111111111
11111111111111111111111111111111111110111111111111111111111111111111111111111111110111111111111011111111111111111111
11111111111111111111111111111111111110111111111111111111111111111111111111111111110111111111111011111111111111111111
11111111111111111111111111111111111110111111111111111111111111111111111111111111110111111111111011111111111111111111
11111111111111111111111111111111111110111111111111111111111111111111111111111111110111111111111011111111111111111111
11111111111111111111111111111111111110111111111111111111111111111111111111111111110111111111111011111111111111111111
11111111111111111111111111111111111110111111111111111111111111111111111111111111110111111111111011111111111111111111
11111111111111111111111111111111111110111111111111111111111111111111111111111111110111111111111011111111111111111111
11111111111111111111111111111111111110111111111111111111111111111111111111111111110111111111111011111111111111111111
11111111111111111111111111111111111110111111111111111111111111111111111111111111110111111111111011111111111111111111
11111111111111111111111111111111111110111111111111111111111111111111111111111111110111111111111011111111111111111111
11111111111111111111111111111111111110111111111111111111111111111111111111111111110111111111111011111111111111111111
11111111111111111111111111111111111110111111111111111111111111111111111111111111110111111111111011111111111111111111
11111111111111111111111111111111111110111111111111111111111111111111111111111111110111111111111011111111111111111111
11111111111111111111111111111111111110111111111111111111111111111111111111111111110111111111111011111111111111111111
11111111111111111111111111111111111110111111111111111111111111111111111111111111110111111111111011111111111111111111
11111111111111111111111111111111111110111111111111111111111111111111111111111111110111111111111011111111111111111111
11111111111111111111111111111111111110111111111111111111111111111111111111111111110111111111111011111111111111111111
11111111111111111111111111111111111110111111111111111111111111111111111111111111110111111111111011111111111111111111
11111111111111111111111111111111111110111111111111111111111111111111111111111111110111111111111011111111111111111111
11111111111111111111111111111111111110111111111111111111111111111111111111111111110111111111111011111111111111111111
11111111111111111111111111111111111110111111111111111111111111111111111111111111110111111111111011111111111111111111
11111111111111111111111111111111111110111111111111111111111111111111111111111111110111111111111011111111111111111111
11111111111111111111111111111111111110111111111111111111111111111111111111111111110111111111111011111111111111111111
11111111111111111111111111111111111110111111111111111111111111111111111111111111110111111111111011111111111111111111
11111111111111111111111111111111111110111111111111111111111111111111111111111111110111111111111011111111111111111111
11111111111111111111111111111111111110111111111111111111111111111111111111111111110111111111111011111111111111111111
11111111111111111111111111111111111110111111111111111111111111111111111111111111110111111111111011111111111111111111
11111111111111111111111111111111111110111111111111111111111111111111111111111111110111111111111011111111111111111111
11111111111111111111111111111111111110111111111111111111111111111111111111111111110111111111111011111111111111111111
11111111111111111111111111111111111110111111111111111111111111111111111111111111110111111111111011111111111111111111
11111111111111111111111111111111111110111111111111111111111111111111111111111111110111111111111011111111111111111111
11111111111111111111111111111111111110111111111111111111111111111111111111111111110111111111111011111111111111111111
11111111111111111111111111111111111110111111111111111111111111111111111111111111110111111111111011111111111111111111
11111111111111111111111111111111111110111111111111111111111111111111111111111111110111111111111011111111111111111111
11111111111111111111111111111111111110111111111111111111111111111111111111111111110111111111111011111111111111111111
11111111111111111111111111111111111110111111111111111111111111111111111111111111110111111111111011111111111111111111
11111111111111111111111111111111111000000111111111111111111111111111111111111111110111111111111011111111111111111111
11111111111111111111111111111111111000000000000000000000000000000000001111111111110111111111111011111111111111111111
11111111111111111111111111111111111000000111111111111111111111111111101111111111110111111111111011111111111111111111
11111111111111111111111111111111111000000111111111111111111111111111101111111111110111111111111011111111111111111111
11111111111111111111111111111111111110111111111111111111111111111111101111111111110111111111111011111111111111111111
11111111111111111111111111111111111110111111111111111111111111111111101111111111110111111111111011111111111111111111
11111111111111111111111111111111111110111111111111111111111111111111101111111111110111111111111011111111111111111111
11111111111111111111111111111111111110111111111111111111111111111111101111111111110111111111111011111111111111111111
11111111111111111111111111111111111110111111111111111111111111111111101111111111000001111111111011111111111111111111
11111111111111111111111111111111111110111111111111111111111111111111101111111111000001111111111011111111111111111111
11111111111111111111111111111111111110111111111111111111111111111111101111111111000001111111111011111111111111111111
11111111111111111111111111111111111110111111111111111111111111111111101111111111000000000111111011111111111111111111
11111111111111111111111111111111111110111111111111111111111111111111101111111111000001110111111011111111111111111111
11111111111111111111111111111111111110111111111111111111111111111111101111111111000001110111111011111111111111111111
11111111111111111111111111111111111110111111111111111111111111111111101111111111000001110111111011111111111111111111
11111111111111111111111111111111111110111111111111111111111111111111101111111111111111110111111011111111111111111111
11111111111111111111111111111111111110111111111111111111111111111111101111111111111111110111111011111111111111111111
11111111111111111111111111111111111110111111111111111111111111111111101111111111111111110111111011111111111111111111
11111111111111111111111111111111111110111111111111111111111111111111101111111111111111110111111011111111111111111111
11111111111111111111111111111111111110111111111111111111111111111111101111111111111111000001111011111111111111111111
11111111111111111111111111111111111110111100000000000000000000000000000000000000000000000001111011111111111111111111
11111111111111111111111111111111111110111101111111111111111111111111101111111111111111000001111011111111111111111111
11111111111111111111111111111111111110111101111111111111111111111111101111111111111111000001111011111111111111111111
11111111111111111111111111111111111110111101111111111111111111111111101111111111111111111111111011111111111111111111
11111111111111111111111111111111111110111101111111111111111111111111101111111111111111111111111011111111111111111111
11111111111111111111111111111111111110111101111111111111111111111111101111111111111111111111111011111111111111111111
11111111111111111111111111111111111110111101111111111111111111111111101111111111111111111111111011111111111111111111
11111111111111111111111111111111111110111101111111111111111111111111101111111111111111111111111011111111111111111111
11111111111111111111111111111111111110111101111111111111111111111111101111111111111111111111111011111111111111111111
11111111111111111111111111111111111110111101111111111111111111111111101111111111111111111111111011111111111111111111
11111111111111111111111111111111111111111101111111111111111111111111101111111111111111111111111011111111111111111111
11111111111111111111111111111111111110111101111111111111111111111111101111111111111111111111111011111111111111111111
11111111111111111111111111111111111110111101111111111111111111111111101111111111111111111111111011111111111111111111
11111111111111111111111111111111111110111101111111111111111111111111101111111111111111111111111011111111111111111111
11111111111111111111111111111111111110111101111111111111111111111111101111111111111111111111111011111111111111111111
11111111111111111111111111111111111110111101111111111111111111111111101111111111111111111111111011111111111111111111
11111111111111111111111111111111111110111101111111111111111111111111101111111111111111111111111011111111111111111111
11111111111111111111111111111111111110111101111111111111111111111111101111111111111111111111111011111111111111111111
11111111111111111111111111111111111110111101111111111111111111111111101111111111111111111111111011111111111111111111
11111111111111111111111111111111111110111101111111111111111111111111101111111111111111111111111011111111111111111111
11111111111111111111111111111111111110111101111111111111111111111111101111111111111111111111111011111111111111111111
11111111111111111111111111111111111110111101111111111111111111111111101111111111111111111111111011111111111111111111
11111111111111111111111111111111111110111101111111111111111111111111101111111111111111111111111011111111111111111111
11111111111111111111111111111111111110111101111111111111111111111111101111111111111111111111111011111111111111111111
11111111111111111111111111111111111110111101111111111111111111111111101111111111111111111111111011111111111111111111
11111111111111111111111111111111111110111101111111111111111111111111101111111111111111111111111011111111111111111111
11111111111111111111111111111111111110111101111111111111111111111111101111111111111111111111111011111111111111111111
11111111111111111111111111111111111110111101111111111111111111111111101111111111111111111111111011111111111111111111
11111111111111111111111111111111111110111101111111111111111111111111101111111111111111111111111011111111111111111111
11111111111111111111111111111111111110111101111111111111111111111111101111111111111111111111111011111111111111111111
11111111111111111111111111111111111110111101111111111111111111111111101111111111111111111111111011111111111111111111
11111111111111111111111111111111111110111101111111111111111111111111101111111111111111111111111011111111111111111111
11111111111111111111111111111111111110111101111111111111111111111111101111111111111111111111111011111111111111111111
11111111111111111111111111111111111110111101111111111111111111111111101111111111111111111111111011111111111111111111
11111111111111111111111111111111111110111101111111111111111111111111101111111111111111111111111011111111111111111111
11111111111111111111111111111111111110111101111111111111111111111111101111111111111111111111111011111111111111111111
11111111111111111111111111111111111110111101111111111111111111111111101111111111111111111111111011111111111111111111
11111111111111111111111111111111111110111101111111111111111111111111101111111111111111111111111011111111111111111111
11111111111111111111111111111111111110111101111111111111111111111111101111111111111111111111111011111111111111111111
11111111111111111111111111111111111110111101111111111111111111111111101111111111111111111111111011111111111111111111
11111111111111111111111111111111111110111101111111111111111111111111101111111111111111111111111011111111111111111111
11111111111111111111111111111111111110111101111111111111111111111111101111111111111111111111111011111111111111111111
11111111111111111111111111111111111110111101111111111111111111111110000011111111111111111111111011111111111111111111
11111111111111111111111111111111111110111101111111111111111111111110000011111111111111111111111011111111111111111111
11111111111111111111111111111111111110111101111111111111111111111110000011111111111111111111111011111111111111111111
11111111111111111111111111111111111110111101111111111111111111111110000011111111111111111111111011111111111111111111
111111111111111111111111111111111111101111011111111111111111111111100D0011111111111111111111111011111111111111111111
11111111111111111111111111111111111110110000001111111111111111111110000011111111111111111111111011111111111111111111
11111111111111111111111111111111111110110000001111111111111111111110000011111111111111111111111011111111111111111111
11111111111111111111111111111111111110110000001111111111111111111110000011111111111111111111111011111111111111111111
11111111111111111111111111111111111110110000001111111111111111111110000011111111111111111111111011111111111111111111
11111111111111111111111111111111111110110000000000000000000000000000000000000000000000000000000011111111111111111111
11111111111111111111111111111111111110110000001111111111111111111111111111111111111111111111111111111111111111111111
11111111111111111111111111111111111110110000001111111111111111111111111111111111111111111111111111111111111111111111
11111111111111111111111111111111111110110000001111111111111111111111111111111111111111111111111111111111111111111111
11111111111111111111111111111111111110110000001111111111111111111111111111111111111111111111111111111111111111111111
11111111111111111111111111111111111110111111111111111111111111111111111111111111111111111111111111111111111111111111
11111111111111111111111111111111110000000011111111111111111111111111111111111111111111111111111111111111111111111111
11111111111111111111111111111111110000000011111111111111111111111111111111111111111111111111111111111111111111111111
11111111111111111111111111111111110000000011111111111111111111111111111111111111111111111111111111111111111111111111
11111111111111111111111111111111110000000011111111111111111111111111111111111111111111111111111111111111111111111111
11111111111111111111111111111111110000000011111111111111111111111111111111111111111111111111111111111111111111111111
11111111111111111111111111111111110000000011111111111111111111111111111111111111111111111111111111111111111111111111
11111111111111111111111111111111110000000011111111111111111111111111111111111111111111111111111111111111111111111111
11111111111111111111111111111111110000000011111111111111111111111111111111111111111111111111111111111111111111111111
11111111111111111111111111111111111111111111111111111111111111111111111111111111111111111111111111111111111111111111
11111111111111111111111111111111111111111111111111111111111111111111111111111111111111111111111111111111111111111111
11111111111111111111111111111111111111111111111111111111111111111111111111111111111111111111111111111111111111111111
11111111111111111111111111111111111111111111111111111111111111111111111111111111111111111111111111111111111111111111
11111111111111111111111111111111111111111111111111111111111111111111111111111111111111111111111111111111111111111111
11111111111111111111111111111111111111111111111111111111111111111111111111111111111111111111111111111111111111111111
