NO      ./graphic/NO.xpm
SO      ./graphic/SO.xpm
WE      ./graphic/WE.xpm
EA      ./graphic/EA.xpm
DO      ./graphic/DO.xpm

F 96,110,66
C 129,141,225

                                                                                                                                                                
                                                                                                                                                                
                                                                                                                                                                
                                                                                                                                                                
                                                                                                                                                                
                                                                                                                                                                
                                                                                                                                                                
                                                                                                                                                                
                                                                                                                                                                
                                                                                                                                                                
        11111111111                                                                                                                                             
       1000000000001                                                                                                                                            
       100000000000111111111111111                                                                                                                              
       1000000000000000000000000001                                                                                                                             
       10000000000000000000000000011                                                                                                                            
       100000000000000000000000000001                                                                                                                           
       100000000000000000000000000001                                                                                                                           
       100000000000000000000000000001                                                                                                                           
       100000000000111111111111000001                                                                                                                           
       1000000000001          1000001                                     1111111111111111111111111111111111111111111111111111111111111                         
        11100000111           1000001                                    1000000000000000000000000000000000000000000000000000000000000011                       
          1000001             1000001                                   110000000000000000000000000000000000000000000000000000000000000001                      
          1000001             1000001                                  1000000000000000000000000000000000000000000000000000000000000000001                      
          1000001             1000001                                  1000000000000000000000000000000000000000000000000000000000000000001                      
          1000001             1000001                                  1000000000000000000000000000000000000000000000000000000000000000001                      
          1000001             1000001                                  1000001111111111111111111111111111111111111111111111111111111000001                      
          1000001             1000001                                  1000001                                                     1000001                      
          1000001             1000001                                  1000001                                                     1000001                      
          1000001             1000001                                  1000001                                                     1000001             11111111 
          1000001             1000001                                  1000001                                                     1000001            1000000001
          1000001             1000001                                  1000001                                                     1000001            1000000001
          1000001            110000011                                 1000001                                                     1000001            1000000001
          1000001           10000000001                                1000001                                                     1000001            1000D00001
          1000001           100000000011111111111111111111111111111111110000011111111111111111111111111111111111111111111111111111110000011111111111111000000001
          1000001           100000000000000000000000000000000000000000000000000000000000000000000000000000000000000000000000000000000000000000000000000000000001
          1000001           100000000000000000000000000000000000000000000000000000000000000000000000000000000000000000000000000000000000000000000000000000000001
          1000001           100000000000000000000000000000000000000000000000000000000000000000000000000000000000000000000000000000000000000000000000000000000001
          1000001           10000000000000000000000000000000000000000000000000000000000000000000000000000000000000000000000000000000000000000000000000000001111 
          1000001           10000000000000000000000000000000000000000000000000000000000000000000000000000000000000000000000000000000000000000000000000000001    
          1000001           1000000000111111111111111111111111111111111100000111111111111111111111111111111111111111111111111111111100000111111111111111111     
          1000001           10000000001                                1000001                                                     1000001                      
          1000001            111111111                                 1000001                                                     1000001                      
          1000001                                                      1000001                                                     1000001                      
          1000001                                                      1000001                                                     1000001                      
          1000001                                                      1000001                                                     1000001                      
          1000001                                                      1000001                                                     1000001                      
          1000001                                                      1000001                                                     1000001                      
          1000001                                                      1000001                                                     1000001                      
          1000001                                                      1000001                                                     1000001                      
          1000001                                                      1000001                                                     1000001                      
          1000001                                                      1000001                                                     1000001                      
          1000001                                                      1000001                                                     1000001                      
          1000001                                                      1000001                                                     1000001                      
          1000001                                                      1000001                                                     1000001                      
          1000001                                                      1000001 11111111111111111111111111111111111111111111111111111000001                      
          1000001                                                      1000001100000000000000000000000000000000000000000000000000000000001                      
          1000001                                                      1000001100000000000000000000000000000000000000000000000000000000001                      
          1000001                                                      1000001100000000000000000000000000000000000000000000000000000000001                      
          1000001                                                      100000110000000000000000000000000000000000000000000000000000000011                       
          1000001                                                      10000011000000000000000000000000000000000000000000000000000000001                        
          1000001                                                      1000001 10000011111111111111111111111111111111111111111111111111                         
          1000001                                                      1000001 1000001                                                                          
          1000001                                                      1000001 1000001                                                                          
          1000001                                                      1000001 1000001                                                                          
          1000001                                                      100000111000001                                                                          
          1000001                   111111111111111111111111111111111111000000000000001                                                                         
          1000001                  1000000000000000000000000000000000000000000000000001                                                                         
          1000001                 11000000000000000000000000000000000000000000000000001                                                                         
          1000001                100000000000000000000000000000000000000000000000N00001                                                                         
          1000001                100000000000000000000000000000000000000000000000000001                                                                         
          1000001                100000000000000000000000000000000000000000000000000001                                                                         
          1000001                100000111111111111111111111111111111111000000000000001                                                                         
          1000001                1000001                               1000000000000001                                                                         
          1000001                1000001                               100000111000001                                                                          
          1000001                1000001                               1000001 1000001                                                                          
          1000001                1000001                               1000001 1000001                                                                          
          1000001                1000001                               1000001 1000001                                                                          
          1000001                1000001                               1000001 1000001                                                                          
          1000001                1000001                               1000001 1000001                                                                          
          1000001                1000001                               1000001 1000001                                                                          
          1000001                1000001                               1000001 1000001                                                                          
          1000001                1000001                               1000001 1000001                                                                          
          1000001                1000001                               1000001 1000001                                                                          
          1000001                1000001                               1000001 1000001                                                                          
          1000001                1000001                               1000001 1000001                                                                          
          1000001                1000001                               1000001 1000001                                                                          
          1000001                1000001                               1000001 1000001                                                                          
          1000001                1000001                               1000001 1000001                                                                          
          1000001                1000001                               1000001 1000001                                                                          
          1000001                1000001                               1000001 1000001                                                                          
          1000001                1000001                               1000001 1000001                                                                          
          1000001                1000001                               1000001 1000001                                                                          
          1000001                1000001                               1000001 1000001                                                                          
          1000001                1000001                               1000001 1000001                                                                          
          1000001                1000001                               1000001 1000001                                                                          
          1000001                1000001                               1000001 1000001                                                                          
          1000001                1000001                               1000001 1000001                                                                          
          1000001                1000001                               1000001 1000001                                                                          
          1000001                1000001                               1000001 1000001                                                                          
          1000001                1000001                               1000001 1000001                                                                          
          1000001                1000001                               1000001 1000001                                                                          
          1000001                1000001                               1000001 1000001                                                                          
          1000001                1000001                               1000001 1000001                                                                          
          1000001                1000001                               1000001 1000001                                                                          
          1000001                1000001                               1000001 1000001                                                                          
          1000001                1000001                               1000001 1000001                                                                          
          1000001                1000001                               1000001 1000001                                                                          
          1000001                1000001                               1000001 1000001                                                                          
          10000011111111111111111100000111111111111111111111111111111111000001 1000001                                                                          
          10000000000000000000000000000000000000000000000000000000000000000001 1000001                                                                          
          1000000000000000000000000000000000000000000000000000000000000000000011000001                                                                          
          1000000000000000000000000000000000000000000000000000000000000000000011000001                                                                          
           110000000000000000000000000000000000000000000000000000000000000000011000001                                                                          
            10000000000000000000000000000000000000000000000000000000000000000011000001                                                                          
             11111111111111111111100000111111111111111111111111111111111111111 1000001                                                                          
                                 1000001                                       1000001                                                                          
                                 1000001                                       1000001                                                                          
                                 1000001                                       1000001                                                                          
                                 1000001                                       1000001                                                                          
                                 1000001                                       1000001                                                                          
                                 1000001                                       1000001                                                                          
                                 1000001                                       1000001                                                                          
                                 1000001                                       1000001                                                                          
                                 1000001                                       1000001                                                                          
                                 1000001                                       1000001                                                                          
                                 1000001                                       1000001                                                                          
                                 1000001                                       1000001                                                                          
                                 1000001                                       1000001                                                                          
                                 1000001                                       1000001                                                                          
                                 1000001                                       1000001                                                                          
                                 1000001                                       1000001                                                                          
                                 1000001                                       1000001                                                                          
                                 1000001                                       1000001                                                                          
                                 1000001                                       1000001                                                                          
                                 1000001                                       1000001                                                                          
                                 1000001                                       1000001                                                                          
                                 1000001                                       1000001                                                                          
                                 1000001                                       1000001                                                                          
                                 1000001                                       1000001                                                                          
                                 1000001                                       1000001                                                                          
                                 1000001                                       1000001                                                                          
                                 1000001                                       1000001                                                                          
                                 1000001                                       1000001                                                                          
                                 1000001                                       1000001                                                                          
                                 1000001                                       1000001                                                                          
                                 1000001                                       1000001                                                                          
                                 1000001                                       1000001                                                                          
                                 1000001                                       1000001                                                                          
                                 1000001                                       1000001                                                                          
                                 1000001                                       1000001                                                                          
                                 1000001                                       1000001                                                                          
                                 1000001                                       1000001                                                                          
                                 1000001                                       1000001                                                                          
                                 1000001                                       1000001                                                                          
                                 1000001                                       1000001                                                                          
                                 1000001                                       1000001                                                                          
                                 1000001                                       1000001                                                                          
                                 10000011111111111111111111111111111111111111111000001                                                                          
                                 10000000000000000000000000000000000000000000000000001                                                                          
                                100000000000000000000000000000000000000000000000000001                                                                          
                                100000000000000000000000000000000000000000000000000001                                                                          
                                10000000000000000000000000000000000000000000000000011                                                                           
                                1000000000000000000000000000000000000000000000000001                                                                            
                                 11111111111111111111111111111111111111111111111111                                                                             
                                                                                                                                                                
                                                                                                                                                                
                                                                                                                                                                
                                                                                                                                                                
                                                                                                                                                                
                                                                                                                                                                
                                                                                                                                                                
                                                                                                                                                                
                                                                                                                                                                
                                                                                                                                                                
                                                                                                                                                                
                                                                                                                                                                
                                                                                                                                                                
