NO      ./graphic/NO.xpm
SO      ./graphic/SO.xpm
WE      ./graphic/WE.xpm
EA      ./graphic/EA.xpm
DO      ./graphic/DO.xpm

F 124,107,155
C 195,215,217

11111111111111111111111111111111111111111111111111111111111111111111111111111111111111111111111111111111111111111111111111111111111
11111111111111111111111111111111111111111111111111111111111111111111111111111111111111111111111111111111111111111111111111111111111
11111111111111111111111111111111111111111111111111111111111111111111111111111111111111111111111111111111111111111111111111111111111
11111111111111111111111111111111111111111111111111111111111111111111111111111111111111111111111111111111111111111111111111111111111
11111111111111111111111111111111111111111111111111111111111111111111111111111111111111111111111111111111111111111111111111111111111
11111111111111111111111111111111111111111111111111111111111111111111111111111111111111111111111111111111111111111111111111111111111
11111111111111111111111111111111111111111111111111111111111111111111111111111111111111111111111111111111111111111111111111111111111
11111111111111111111111111111111111111111111111111111111111111111111111111111111111111111111111111111111111111111111111111111111111
11111111111111111111111111111111111111111111111111111111111111111111111111111111111111111111111111111111111111111111111111111111111
11111111111111111111111111111111111111111111111111111111111111111111111111111111111111111111111111111111111111111111111111111111111
11111111111111111111111111111111111111111111111111111111111111111111111111111111111111111111111111111111111111111111111111111111111
11111111111111111111111111111111111111111111111111111111111111111111111111111111111111111111111111111111111111111111111111111111111
11111111111111111111111111111111111111111111111111111111111111111111111111111111111111111111111111111111111111111111111111111111111
11111111111111111111111111111111111111111111111111111111111111111111111111111111111111111111111111111111111111111111111111111111111
11111111111111111111111111111111111111111111111111111111111111111111111111111111111111111111111111111111111111111111111111111111111
11111111111111111111111111111111111111111111111111111111111111111111111111111111111111111111111111111111111111111111111111111111111
11111111111111111111111111111111111111111111111111111111111111111111111111111111111111111111111111111111111111111111111111111111111
11111111111111111111111111111111111111111111111111111111111111111111111111111111111111111111111111111111111111111111111111111111111
11111111111111111111111111111111111111111111111111111111111111111111111111111111111111111111111111111111111111111111111111111111111
11111111111111111111111111111111111111111111111111111111111111111111111111111111111111111111111111111111111111111111111111111111111
11111111111111111111111111111111111111111111111111111111111111111111111111111111111111111111111111111111111111111111111111111111111
11111111111111111111111111111111111111111111111111111111111111111111111111111111111111111111111111111111111111111111111111111111111
11111111111111111111111111111111111111111111111111111111111111111111111111111111111111111111111111111111111110000000000111111111111
11111111111111111111111111111111111111111111111111111111111111111111111111111111111111111111111111111111111110000000000111111111111
11111111111111111111111111111111111111111111111111111111111111111111111111111111111111111111111111111111111110000000000111111111111
11111111111111111111111111111111111111111111111111111111111111111111111111111111111111111111111111111111111110000000000111111111111
11111111111111111111111111111111111111111111111111111111111111111111111111111111111111111111111111111111111110000D00000111111111111
11111111111111111111111111111111111111111111111111111111111111111111111111111111111111111111111111111111111110000000000111111111111
11111111111111111111111111111111111111111111111111111111111111111111111111111111111111111111111111111111111110000000000111111111111
11111111111111111111111111111111111111111111111111111111111111111111111111111111111111111111111111111111111110000000000111111111111
11111111111111111111111111111111111111111111111111111111111111111111111111111111111111111111111111111111111110000000000111111111111
11111111111111111111111111111111111111111111111111111111111111111111111111111111111111111111111111111111111111111011111111111111111
11111111111111111111111111111111111111111111111111111111111111111111111111111111111111111111111111111111111111111011111111111111111
11111111111111111111111111111111111111111111111111111111111111111111111111111111111111111111111111111111111111111011111111111111111
11111111111111111111111111111111111111111111111111111111111111111111111111111111111111111111111111111111111111111011111111111111111
11111111111111111111111111111111111111111111111111111111111111111111111111111111111111111111111111111111111111111011111111111111111
11111111111111111111111111111111111111111111111111111111111111111111111111111111111111111111111111111111111111111011111111111111111
11111111111111111111111111111111111111111111111111111111111111111111111111111111111111111111111111111111111111111011111111111111111
11111111111111111111111111111111111111111111111111111111111111111111111111111111111111111111111111111111111111111011111111111111111
11111111111111111111111111111111111111111111111111111111111111111111111111111111111111111111111111111111111111111011111111111111111
11111111111111111111111111111111111111111111111111111111111111111111111111111111111111111111111111111111111111111011111111111111111
11111111111111111111111111111111111111111111111111111111111111111111111111111111111111111111111111111111111111111011111111111111111
11111111111111111111111111111111111111111111111111111111111111111111111111111111111111111111111111111111111111111011111111111111111
11111111111111111111111111111111111111111111111111111111111111111111111111111111111111111111111111111111111111111011111111111111111
11111111111111111111111111111111111111111111111111111111111111111111111111111111111111111111111111111111111111111011111111111111111
11111111111111111111111111111111111111111111111111111111111111111111111111111111111111111111111111111111111111110000000011111111111
11111111111111111111111111111111111111111111111111111111111111111111111111111111111111111111111111111111111111110000000011111111111
11111111111111111111111111111111111100000111111111111111111111111111111111111111111111111111111111111111111111110000000001111111111
11111111111111111111111111111111111100S00000000000000000000001111111111111111111111111111111111111111111111111110000000001111111111
11111111111111111111111111111111111100000111111111111111111101111111111111111111111111111111111111111111111111110000000001111111111
11111111111111111111111111111111111100000111111111111111111101111111111111111111111111111111111111111111111111111010111101111111111
11111111111111111111111111111111111111111111111111111111111101111111111111111111111111111111111111111111111111111010111101111111111
11111111111111111111111111111111111111111111111111111111111101111111111111111111111111111111111111111111111111111010111101111111111
11111111111111111111111111111111111111111111111111111111111101111111111111111111111111111111111111111111111111111010111101111111111
11111111111111111111111111111111111111111111111111111111111101111111111111111111111111111111111111111111111111111010111101111111111
11111111111111111111111111111111111111111111111111111111111101111111111111111111111111111111111111111111111111111010111101111111111
11111111111111111111111111111111111111111111111111111111111101111111111111111111111111111111111111111111111111111010111101111111111
11111111111111111111111111111111111111111111111111111111111101111111111111111111111111111111111111111111111111111010111101111111111
11111111111111111111111111111111111111111111111111111111111101111111111111111111111111111111111111111111111111111010111101111111111
11111111111111111111111111111111111111111111111111111111111101111111111111111111111111111111111111111111111111111010111101111111111
11111111111111111111111111111111111111111111111111111111111101111111111111111111111111111111111111111111111111111010111101111111111
11111111111111111111111111111111111111111111111111111111111101111111111111111111111111111111111111111111111111111010111101111111111
11111111111111111111111111111111111111111111111111111111111101111111111111111111111111111111111111111111111111111010111101111111111
11111111111111111111111111111111111111111111111111111111111101111111111111111111111111111111111111111111111111111010111101111111111
11111111111111111111111111111111111111111111111111111111111101111100000000011111111111111111111111111111111111111010111101111111111
11111111111111111111111111111111111111111111111111111111111101111100000000011111111111111111111111111111111111111010111101111111111
11111111111111111111111111111111111111111111111111111111111101111100000000011111111111111111111111111111111111111010111101111111111
11111111111111111111111111111111111111111111111111111111111101111100000000011111111111111111111111111111111111111010111101111111111
11111111111111111111111111111111111111100000000000000000000000000000000000011111111111111111111111111111111111111010111101111111111
11111111111111111111111111111111111111101111111111111111111101111100000000011111111111111111111111111111111111111010111101111111111
11111111111111111111111111111111111111101111111111111111111101111100000000011111111111111111111111111111111111111010111101111111111
11111111111111111111111111111111111111101111111111111111111101111100000000011111111111111111111111111111111111111010111101111111111
11111111111111111111111111111111111111101111111111111111111101111100000000011111111111111111111111111111111111111010000000000011111
11111111111111111111111111111111111111101111111111111111111101111111110111111111111111111111111111111111111111111010000000000011111
11111111111111111111111111111111111111101111111111111111111101111111110000000000000000000000000000000000000000000000000000000011111
11111111111111111111111111111111111111101111111111111111111101111111111111111111111111111111111111111111111111111010000000000011111
11111111111111111111111111111111111111101111111111111111111101111111111111111111111111111111111111111111111111111010000000000011111
11111111111111111111111111111111111111101111111111111111111101111111111111111111111111111111111111111111111111111010111111111111111
11111111111111111111111111111111111111101111111111111111111101111111111111111111111111111111111111111111111111111010111111111111111
11111111111111111111111111111111111111101111111111111111111101111111111111111111111111111111111111111111111111111010111111111111111
11111111111111111111111111111111111111101111111111111111111101111111111111111111111111111111111111111111111111111010111111111111111
11111111111111111111111111111111111111000011111111111111111101111111111111111111111111111111111111111111111111111010111111111111111
11111111111111111111111111111111111111000011111111111111111101111111111111111111111111111111111111111111111111111010111111111111111
11111111111111111111111111111111111111000000000000000000000000000000000000000000000000000000000000000000000000000010111111111111111
11111111111111111111111111111111111111000011111111111111110000011111111111111111111111111111111110000111111111111110111111111111111
11111111111111111111111111111111111111000011111111111111110000011111111111111111111111111111111110000000000000000000111111111111111
11111111111111111111111111111111111111000011111111111111110000000000000000000000000000000000000000000111111111111111111111111111111
11111111111111111111111111111111111111111111111111111111110000011111111111111111111111111111111110000111111111111111111111111111111
11111111111111111111111111111111111111111111111111111111110000011111111111111111111111111111111111111111111111111111111111111111111
11111111111111111111111111111111111111111111111111111111110000011111111111111111111111111111111111111111111111111111111111111111111
11111111111111111111111111111111111111111111111111111111111111111111111111111111111111111111111111111111111111111111111111111111111
11111111111111111111111111111111111111111111111111111111111111111111111111111111111111111111111111111111111111111111111111111111111
11111111111111111111111111111111111111111111111111111111111111111111111111111111111111111111111111111111111111111111111111111111111
11111111111111111111111111111111111111111111111111111111111111111111111111111111111111111111111111111111111111111111111111111111111
11111111111111111111111111111111111111111111111111111111111111111111111111111111111111111111111111111111111111111111111111111111111
11111111111111111111111111111111111111111111111111111111111111111111111111111111111111111111111111111111111111111111111111111111111
11111111111111111111111111111111111111111111111111111111111111111111111111111111111111111111111111111111111111111111111111111111111
11111111111111111111111111111111111111111111111111111111111111111111111111111111111111111111111111111111111111111111111111111111111
11111111111111111111111111111111111111111111111111111111111111111111111111111111111111111111111111111111111111111111111111111111111
