NO      ./graphic/NO.xpm
SO      ./graphic/SO.xpm
WE      ./graphic/WE.xpm
EA      ./graphic/EA.xpm
DO      ./graphic/DO.xpm

F 133,125,145
C 213,192,165

111111111111111111111111111111111111111111111111111111111111111111111111111111
111111111111111111111111111111111111111111111111111111111111111111111111111111
111111111111111111111111111111111111111111111111111111111111111111111111111111
111111111111111111111111111111111111111111111111111111111111111111111111111111
111111111111111111111111111111111111111111111111111111111111111111111111111111
111111111111111111111111111111111111111111111111111111111111111111111111111111
111111111111111000011111111111111111111111111111111111111111111111111111111111
111100000000000000011111111111111111111111111111111111111111111111111111111111
111101111111111000011111111111111111111111111111111111111111111111111111111111
111101111111111000011111111111111111111111111111111111111111111111111111111111
111101111111111101111111111111111111111111111111111111111111111111111111111111
111101111111111101111111111111111111111111111111111111111111111111111111111111
111101111111111101111111111111111111111111111111111111111111111111111111111111
111101111111111101111111111111111111111111111111111111111111111111111111111111
111101111111111101111111111111111111111111111111111111111111111111111111111111
111101111111111101111111111111111111111111111111111111111111111111111111111111
111101111111111101111111111111111111111111111111111111111111111111111111111111
111101111111111101111111111111111111111111111111111111111111111111111111111111
111101111111111101111111111111111111111111111111111111111111111111111111111111
111101111111111101111111111111111111111111111111111111111111111111111111111111
111101111111111101111111111111111111111111111111111111111111111111111111111111
111101111111111101111111111111111111111111111111111111111111111111111111111111
111101111111111101111111111111111111111111111111111111111111111111111111111111
111101111111111101111111111111111111111111111111111111111111111111111111111111
111101111111111101111111111111111111111111111111111111111111111111111111111111
111101111111111101111111111111111111111111111111111111111111111111111111111111
111101111111111101111111111111111111111111111111111111111111111111111111111111
111101111111111101111111111111111111111111111111111111111111111111111111111111
111101111111111101111111111111111111111111111111111111111111111111111111111111
111101111111111101111111111111111111111111111111111111111111111111111111111111
111101111111111101111111111111111111111111111111111111111111111111111111111111
111101111111111101111111111111111111111111111111111111111111111111111111111111
111101111111111101111111111111111111111111111111111111111111111111111111111111
111101111111111101111111111111111111111111111111111111111111111111111111111111
111101111111111101111111111111111111111111111111111111111111111111111111111111
111101111111111101111111111111111111111111111111111111111111111111111111111111
111101111111111101111111111111111111111111111111111111111111111111111111111111
111101111111111101111111111111111111111111111111111111111111111111111111111111
111101111111111101111111111111111111111111111111111111111111111111111111111111
111101111111111101111111111111111111111111111111111111111111111111111111111111
111101111111111101111111111111111111111111111111111111111111111111111111111111
111101111111111101111111111111111111111111111111111111111111111111111111111111
111101111111111101111111111111111111111111111111111111111111111111111111111111
111101111111111111111111111111111111111111111111111111111111111111111111111111
111101111111111101111111111111111111111111111111111111111111111111111111111111
111101111111111101111111111111111111111111111111111111111111111111111111111111
111101111111111101111111111111111111111111111111111111111111111111111111111111
111101111111111101111111111111111111111111111111111111111111111111111111111111
111101111111111101111111111111111111111111111111111111111111111111111111111111
111101111111111101111111111111111111111111111111111111111111111111111111111111
111101111111111101111111111111111111111111111111111111100001111111111111111111
111101111111111101111111111111111111111111111111111111100001111111111111111111
11110111111100000000000000000000000000000000000000000000E001111111111111111111
111101111111011101111111111111111111111111111111111111100001111111111111111111
111101111111011101111111111111111111111111111111111111100001111111111111111111
111101111111011101111111111111111111111111111111111111100001111111111111111111
111101111111011101111111111111111111111111111111111111111111111111111111111111
111101111111011101111111111111111111111111111111111111111111111111111111111111
111101111111011101111111111111111111111111111111111111111111111111111111111111
111101111111011101111111111111111111111111111111111111111111111111111111111111
111101111111011101111111111111111111111111111111111111111111111111111111111111
111101111111011101111111111111111111111111111111111111111111111111111111111111
111101111111011101111111111111111111111111111111111111111111111111111111111111
111101111111011101111111111111111111111111111111111111111111111111111111111111
111101111111011101111111111111111111111111111111111111111111111111111111111111
111101111111011101111111111111111111111111111111111111111111111111111111111111
111101111111011101111111111111111111111111111111111111111111111111111111111111
111101111111011101111111111111111111111111111111111111111111111111111111111111
111101111111011101111111111111111111111111111111111111111111111111111111111111
111101111111011101111111111111111111111111111111111111111111111111111111111111
111101111111011101111111111111111111111111111111111111111111111111111111111111
111101111111011101111111111111111111111111111111111111111111111111111111111111
111101111111011101111111111111111111111111111111111111111111111111111111111111
111101111111011101111111111111111111111111111111111111111111111111111111111111
111101111111011101111111111111111111111111111111111111111111111111111111111111
111101111111011101111111111111111111111111111111111111111111111111111111111111
111101111111011101111111111111111111111111111111111111111111111111111111111111
111101111111011101111111111111111111111111111111111111111111111111111111111111
111101111111011101111111111111111111111111111111111111111111111111111111111111
111101111111011101111111111111111111111111111111111111111111111111111111111111
111101111111011101111111111111111111111111111111111111111111111111111111111111
111101111111011101111111111111111111111111111111111111111111111111111111111111
111101111111011101111111111111111111111111111111111111111111111111111111111111
111101111111011101111111111111111111111111111111111111111111111111111111111111
111101111111011101111111111111111111111111111111111111111111111111111111111111
111101111111011101111111111111111111111111111111111111111111111111111111111111
111101111000000001111111111111111111111000000000011111111111111111111111111111
111101111000000001111111111111111111111000000000011111111111000000001111111111
111101111000000001111111111111111111111000000000000000000000000000001111111111
111101111000000000000000000000000000000000000000011111111111000000001111111111
110000011000000001111111111111111111111000000000011111111111000000001111111111
110000011000000001111111111111111111111111111111111111111111000000001111111111
110000000000000000000000000000001111111111111111111111111111000000001111111111
110000011111111101111111111111101111111111111111111111110000000000011111111111
110000011111111101111111111111101111111111111111111111110000000000011111111111
111111111111111101111111111111101111111111111111111111110000000000011111111111
111111111111111100000000000000000000000000000000000000000000000000011111111111
111111111111111111111111111111101111111111111111111111110000000000011111111111
111111111111111111111111111111101111111111111111111111110000000000011111111111
111111111111111111111111111111101111111111111111111111110000000000011111111111
111111111111111111111111111111101111111111111111111111111111111111111111111111
111111111111111111111111111100000000111111111111111111111111111111111111111111
111111111111111111111111111100000000111111111111111111111111111111111111111111
111111111111111111111111111100000000111111111111111111111111111111111111111111
1111111111111111111111111111000D0000111111111111111111111111111111111111111111
111111111111111111111111111100000000111111111111111111111111111111111111111111
111111111111111111111111111100000000111111111111111111111111111111111111111111
111111111111111111111111111100000000111111111111111111111111111111111111111111
111111111111111111111111111100000000111111111111111111111111111111111111111111
111111111111111111111111111111111111111111111111111111111111111111111111111111
111111111111111111111111111111111111111111111111111111111111111111111111111111
111111111111111111111111111111111111111111111111111111111111111111111111111111
111111111111111111111111111111111111111111111111111111111111111111111111111111
111111111111111111111111111111111111111111111111111111111111111111111111111111
111111111111111111111111111111111111111111111111111111111111111111111111111111
111111111111111111111111111111111111111111111111111111111111111111111111111111
111111111111111111111111111111111111111111111111111111111111111111111111111111
111111111111111111111111111111111111111111111111111111111111111111111111111111
111111111111111111111111111111111111111111111111111111111111111111111111111111
111111111111111111111111111111111111111111111111111111111111111111111111111111
111111111111111111111111111111111111111111111111111111111111111111111111111111
111111111111111111111111111111111111111111111111111111111111111111111111111111
111111111111111111111111111111111111111111111111111111111111111111111111111111
111111111111111111111111111111111111111111111111111111111111111111111111111111
