NO      ./graphic/NO.xpm
SO      ./graphic/SO.xpm
WE      ./graphic/WE.xpm
EA      ./graphic/EA.xpm
DO      ./graphic/DO.xpm

F 114,104,75
C 243,152,163

                                                                                         
                                                                                         
                                                                                         
                                                                                         
                                                                                         
                                                                                         
                                                                                         
                                                                                         
                                                                                         
                                                                                         
                                                                                         
                                                                                         
                                                                                         
                                                                                         
                                                                                         
                                                                                         
                                                                                         
                                                      1111111                            
                                                     100000001                           
                                            111111111100000001                           
                                           1000000000000000001                           
                                          11000000000000000001                           
      11111111111111111111111111111111111100000000000000000001                           
     100000000000000000000000000000000000000000000000000000001                           
    1100000000000000000000000000000000000000000000000000000001                           
   10000000000000000000000000000000000000000000111111100000001                           
   100000000000000000000000000000000000000000001     100000001                           
   100000000000000000000000000000000000000000001      1000001                            
   100000111111111111111111111111111111111000001      1000001                            
   1000001                               1000001      1000001111111111111111111111111    
   1000001                                11111       10000000000000000000000000000001   
   100D001                                            10000000000000000000000000000001   
    100001                                            10000000000000000000000000000001   
    100001                                             1100000000000000000000000000001   
    100001                                              100000000000000000000000000001   
    100001                                               11111111111111111111111000001   
     1111                                                                      1000001   
                                                                               1000001   
                                                                               1000001   
                                                                               1000001   
                                                                               1000001   
                                                                               1000001   
                                                                               1000001   
                                                                               1000001   
                                                                               1000001   
                                                                               1000001   
                                                                               1000001   
                                                                               1000001   
                                                                               1000001   
                                                                               1000001   
                                                                               1000001   
                                                                               1000001   
                                                                               1000001   
                                                                         1111111000001   
                                                                        10000000000001   
                                                                      1110000000000001   
                                                                     10000000000000001   
                                                                    110000000000000001   
                                                                   1000000000000000001   
                                                                   1000000000000000001   
                                                                   1000000000000000001   
                                                                   1000000000000000001   
                                                                   1000000000000000001   
                                                                   1000001100000000001   
                                                                   1000001100000000001   
                                                                   1000001100000000001   
                                                                   1000001100000000001   
                                                                   1000001100000000001   
                                                                   1000001100000000001   
                                                                   1000001100000000001   
                                                                   10000011000000000001  
                                                                   10000011000000000001  
                                                                   10000010000000000001  
                                                                 1110000010000000000001  
                                                                10000000000000000N00001  
                                                                10000000000000000000001  
                                                                10000000000000000000001  
                                                                10000000000000000000001  
                                                                10000000000000000000001  
                                                                1000000000000000000111   
                                                                10000000000000000001     
                                                                1000000000000000111      
                                                                10000000000000001        
                                                                 1111111000000001        
                                                                     100000000001        
                                                                     100000000001        
                                                                     100000000001        
                                                                     100000000001        
                                                                     100000000001        
                                                                     10000000001         
                                                                     10000000001         
                                                                     10000000001         
                                                                     10000000001         
                                                                      111111111          
                                                                                         
                                                                                         
                                                                                         
                                                                                         
                                                                                         
                                                                                         
                                                                                         
                                                                                         
                                                                                         
                                                                                         
                                                                                         
                                                                                         
                                                                                         
                                                                                         
                                                                                         
                                                                                         
                                                                                         
                                                                                         
                                                                                         
                                                                                         
                                                                                         
                                                                                         
                                                                                         
                                                                                         
                                                                                         
                                                                                         
                                                                                         
                                                                                         
                                                                                         
                                                                                         
                                                                                         
                                                                                         
