NO      ./graphic/NO.xpm
SO      ./graphic/SO.xpm
WE      ./graphic/WE.xpm
EA      ./graphic/EA.xpm
DO      ./graphic/DO.xpm

F 83,119,109
C 221,156,162

   11111111111           
  1000000000001          
  1000000000001          
  10000000000011111      
  100000000000000001     
  10000D000000000001     
  1000000000000000011    
  10000000000000000001   
  100000000000000000011  
  1000000000000000000001 
   111000000000000000001 
     10000000000000E0001 
     1000000000000000001 
     1000000000000000001 
     1000000000000000001 
     100000000000000001  
     100000000000000001  
      11000000000000001  
       1000000000000001  
        111111100000001  
              100000001  
               1111111   
