NO      ./graphic/NO.xpm
SO      ./graphic/SO.xpm
WE      ./graphic/WE.xpm
EA      ./graphic/EA.xpm
DO      ./graphic/DO.xpm

F 156,125,180
C 170,217,160

11111111111111111111111111111111111111111111111111111111111111111111111111111111111111111111111111111111111111111111
11111111111111111111111111111111111111111111111111111111111111111111111111111111111111111111111111111111111111111111
11111111111111111111111111111111111111111111111111111111111111111111111111111111111111111111111111111111111111111111
11111111111111111111111111111111111111111111111111111111111111111111111111111111111111111111111111111111111111111111
11111111111111111111111111111111111111111111111111111111111111111111111111111111111111111111111111111111111111111111
11111111111111111111111111111111111111111111111111111111111111111111111111111111111111111111111111111111111111111111
11111111111111111111111111111111111111111111111111111111111111111111111111111111111111111111111111111111111111111111
11111111111111111111111111111111111111111111111111111111111111111111111111111111111111111111111111111111111111111111
11111111111111111111111111111111111111111111111111111111111111111111111111111111111111111111111111111111111111111111
11111111111111111111111111111111111111111111111111111111111111111111111111111111111111111111111111111111111111111111
11111111111111111111111111111111111111111111111111111111111111111111111111111111111111111111111111111111111111111111
11111111111111111111111111111111111111111111111111111111111111111111111111111111111111111111111111111111111111111111
11111111111111111111111111111111111111111111111111111111111111111111111111111111111111111111111111111111111111111111
11111111111111111111111111111111111111111111111111111111111111111111111111111111111111111111111111111111111111111111
11111111111111111111111111111111111111111111111111111111111111111111111111111111111111111111111111111111111111111111
11111111111111111111111111111111111111111111111111111111111111111111111111111111111111111111111111111111111111111111
11111111111111111111111111111111111111111111111111111111111111111111111111111111111111111111111111111111111111111111
11111111111111111111111111111111111111111111111111111111111111111111111111111111111111111111111111111111111111111111
11111111111111111111111111111111111111111111111111111111111111111111111111111111111111111111111111111111111111111111
11111111111111111111111111111111111111111111111111111111111111111111111111111111111111111111111111111111111111111111
11111111111111111111111111111111111111111111111111111111111111111111111111111111111111111111111111111111111111111111
11111111111111111111111111111111111111111111111111111111111111111111111111111111111111111111111111111111111111111111
11111111111111111111111111111111111111111111111111111111111111111111111111111111111111111111111111111111111111111111
11111111111111111111111111111111111111111111111111111111111111111111111111111111111111111111111111111111111111111111
11111111111111111111111111111111111111111111111111111111111111111111111111111111111111111111111111111111111111111111
11111111111111111111111111111111111111111111111111111111111111111111111111111111111111111111111111111111111111111111
11111100000000011111111111111111111111111111111111111111111111111111111111111111111111111111111111111111111111111111
11111100000000011111111111111111111111111111111111111111111111111111111111111111111111111111111111111111111111111111
11111100000000000000000000000000000000000000000000000000000000000000000000000000000000000000001111111111111111111111
11111100000000011111111111111111111111111111111111111111111111111111111111111111111111111111101111111111111111111111
11111100000000011111111111111111111111111111111111111111111111111111111111111111111111111111101111111111111111111111
11111111110111111111111111111111111111111111111111111111111111111111111111111111111111111111101111111111111111111111
11111111110111111111111111111111111111111111111111111111111111111111111111111111111111111111101111111111111111111111
11111111110111111111111111111111111111111111111111111111111111111111111111111111111111111111101111111111111111111111
11111111110111111111111111111111111111111111111111111111111111111111111111111111111111111111101111111111111111111111
11111111110111111111111111111111111111111111111111111111111111111111111111111111111111111111101111111111111111111111
11111111110111111111111111111111111111111111111111111111111111111111111111111111111111111111101111111111111111111111
11111111110111111111111111111111111111111111111111111111111111111111111111111111111111111111101111111111111111111111
11111111110111111111111111111111111111111111111111111111111111111111111111111111111111111111101111111111111111111111
11111111110111111111111111111111111111111111111111111111111111111111111111111111111111111111101111111111111111111111
11111111110111111111111111111111111111111111111111111111111111111111111111111111111111111111101111111111111111111111
11111111110111111111111111111111111111111111111111111111111111111111111111111111111111111111101111111111111111111111
11111111110111111111111111111111111111111111111111111111111111111111111111111111111111111000000000111111111111111111
11111111110111111111111111111111111111111111111111111111111111111111111111111111111111111000000000111111111111111111
11111111110111111111111111111111111111111111111111111111111111111111111111111111111111111000000000111111111111111111
11111111110111111111111111111111111111111111111111111111000000000000000000000000000000000000000000111111111111111111
11111111110111111111111111111111111111111111111111111111011111111111111111111111111111111000000000111111111111111111
11111111110111111111111111111111111111111111111111111111011111111111111111111111111111111000000000111111111111111111
11111111110111111111111111111111111111111111111111111111011111111111111111111111111111111000000000111111111111111111
11111111110111111111111111111111111111111111111111111111011111111111111111111111111111111111111111111111111111111111
11111111110111111111111111111111111111111111111111111111011111111111111111111111111111111111111111111111111111111111
11111111110111111111111111111111111111111111111111111111011111111111111111111111111111111111111111111111111111111111
11111111110111111111111111111111111111111111111111111111011111111111111111111111111111111111111111111111111111111111
11111111110111111111111111111111111111111111111111111111011111111111111111111111111111111111111111111111111111111111
11111111110111111111111111111111111111111111111111111111011111111111111111111111111111111111111111111111111111111111
11111111110111111111111111111111111111111111111111111111011111111111111111111111111111111111111111111111111111111111
11111111110111111111111111111111111111111111111111111111011111111111111111111111111111111111111111111111111111111111
11111111110111111111111111111111111111111111111111111111011111111111111111111111111111111111111111111111111111111111
11111111110111111111111111111111111111111111111111111111011111111111111111111111111111111111111111111111111111111111
11111111110111111111111111111111111111111111111111111111011111111111111111111111111111111111111111111111111111111111
11111111110111111111111111111111111111111111111111111111011111111111111111111111111111111111111111111111111111111111
11111111110111111111111111111111111111111111111111111111011111111111111111111111111111111111111111111111111111111111
11111111110111111111111111111111111111111111111111111111011111111111111111111111111111111111111111111111111111111111
11111111110111111111111111111111111111111111111111111111011111111111111111111111111111111111111111111111111111111111
11111111110111111111111111111111111111111111111111111111011111111111111111111111111111111111111111111111111111111111
11111111110111111111111111111111111111111111111111111111011111111111111111111111111111111111111111111111111111111111
11111111110111111111111111111111111111111111111111111111011111111111111111111111111111111111111111111111111111111111
11111111110111111111111111111111111111111111111111111111011111111111111111111111111111111111111111111111111111111111
11111111110111111111111111111111111111111111111111111111011111111111111111111111111111111111111111111111111111111111
11111111110111111111111111111111111111111111111111111111011111111111111111111111111111111111111111111111111111111111
11111111110111111111111111111111111111111111111111111111011111111111111111111111111111111111111111111111111111111111
11111111110111111111111111111111111111111111111111111111011111111111111111111111111111111111111111111111111111111111
11111111110111111111111111111111111111111111111111111111011111111111111111111111111111111111111111111111111111111111
11111111110111111111111111111111111111111111111111111111011111111111111111111111111111111111111111111111111111111111
11111111110111111111111111111111111111111111111111111111011111111111111111111111111111111111111111111111111111111111
11111111110111111111111111111111111111111111111111111111011111111111111111111111111111111111111111111111111111111111
11111111110111111111111111111111111111111111111111111111011111111111111111111111111111111111111111111111111111111111
11111111110111111111111111111111111111111111111111111111011111111111111111111111111111111111111111111111111111111111
11111111110111111111111111111111111111111111111111111111011111111111111111111111111111111111111111111111111111111111
11111111110111111111111111111111111111111111111111111111011111111111111111111111111111111111111111111111111111111111
11111111110111111111111111111111111111111111111111111111011111111111111111111111111111111111111111111111111111111111
11111111110111111111111111111111111111111111111111111111011111111111111111111111110000000011111111111111111111111111
11111111110111111111111111111111111111111111111111111111011111111111111111111111110000000011111111111111111111111111
11111111110111111111111111111111111111111111111111111111011111111111111111111111110000000011111111111111111111111111
11111111110111111111111111111111111111111111111111111111011111111111111111111111110000000011111111111111111111111111
11111111110111111111111111111111111111111111111111111000000000000000000000000000000000000011111111111111111111111111
11111111110111111111111111111111111111111111111111111000000011111111111111111111110000000011111111111111111111111111
11111111110111111111111111111111111111111111111111111000000000000000000000000000000000000011111111111111111111111111
11111111110111111111111111111111111111111111111111111000000011111111111111111111110000000011111111111111111111111111
11111111110111111111111111111111111111111111111111111000000011111111111111111111110000000011111111111111111111111111
11111111110111111111111111111111111111111111111111111111110111111111111111111111111111111111111111111111111111111111
11111111110111111111111111111111111111111111111111111111110111111111111111111111111111111111111111111111111111111111
11111111110111111111111111111111111111111111111111111111110111111111111111111111111111111111111111111111111111111111
11111111110111111111111111111111111111111111111111111111110111111111111111111111111111111111111111111111111111111111
11111111110111111111111111111111111111111111111111111111110111111111111111111111111111111111111111111111111111111111
11111111110111111111111111111111111111111111111111111111110111111111111111111111111111111111111111111111111111111111
11111111110111111111111111111111111111111111111111111111110111111111111111111111111111111111111111111111111111111111
11111111110111111111111111111111111111111111111111111111110111111111111111111111111111111111111111111111111111111111
11111111110111111111111111111111111111111111111111111111110111111111111111111111111111111111111111111111111111111111
11111111110111111111111111111111111111111111111111111111110111111111111111111111111111111111111111111111111111111111
11111111110111111111111111111111111111111111111111111111110111111111111111111111111111111111111111111111111111111111
11111111110111111111111111111111111111111111111111111111110111111111111111111111111111111111111111111111111111111111
11111111110111111111111111111111111111111111111111111111110111111111111111111111111111111111111111111111111111111111
11111111110111111111111111111111111111111111111111111111110111111111111111111111111111111111111111111111111111111111
11111111110111111111111111111111111111111111111111111111110111111111111111111111111111111111111111111111111111111111
11111111110111111111111111111111111111111111111111111111110111111111111111111111111111111111111111111111111111111111
11111111110111111111111111111111111111111111111111111111110111111111111111111111111111111111111111111111111111111111
11111111110111111111111111111111111111111111111111111111110111111111111111111111111111111111111111111111111111111111
11111111110111111111111111111111111111111111111111111111110111111111111111111111111111111111111111111111111111111111
11111111110111111111111111111111111111111111111111111111110111111111111111111111111111111111111111111111111111111111
11111111110111111111111111111111111111111111111111111111110111111111111111111111111111111111111111111111111111111111
11111111110111111111111111111111111111111111111111111111110111111111111111111111111111111111111111111111111111111111
11111111110111111111111111111111111111111111111111111111110111111111111111111111111111111111111111111111111111111111
11111111110111111111111111111111111111111111111111111111110111111111111111111111111111111111111111111111111111111111
11111111110111111111111111111111111111111111111111111111110111111111111111111111111111111111111111111111111111111111
11111111110111111111111111111111111111111111111111111111110111111111111111111111111111111111111111111111111111111111
11111111110111111111111111111111111111111111111111111111110111111111111111111111111111111111111111111111111111111111
11111111110111111111111111111111111111111111111111111111110111111111111111111111111111111111111111111111111111111111
11111111110111111111111111111111111111111111111111111111110111111111111111111111111111111111111111111111111111111111
11111111110111111111111111111111111111111111111111111111110111111111111111111111111111111111111111111111111111111111
11111111110111111111111111111111111111111111111111111111110111111111111111111111111111111111111111111111111111111111
11111111110111111111111111111111111111110000000011111111110111111111111111111111111111111111111111111111111111111111
11111111110111111111111111111111111111110000000011111111110111111111111111111111111111111111111111111111111111111111
11111111110111111111111111111111111111110000000011111111110111111111111111111111111111111111111111111111111111111111
1111111111011111111111111111111111111111000W000000000000000000000000000011111111111111111111111111111111111111111111
11111111110111111111111111111111111111110000000011111111110111111111111011111111111111111111111111111111111111111111
11111111110111111111111111111111111111110000000011111111110111111111111011111111111111111111111111111111111111111111
11111111110111111111111111111111111111110000000011111111110111111111111011111111111111111111111111111111111111111111
11111111110111111111111111111111111111111111111111111111110111111111100000111111111111111111111111111111111111111111
11111111110111111111111111111111111111111111111111111111110111111111100000111111111111111111111111111111111111111111
11111111110111111111111111111111111111111111111111111111110111111100000000111111111111111111111111111111111111111111
11111111110000000000000000010000000000000000000000000000000000000000000000111111111111111111111111111111111111111111
11111111111111111111111111111111111111111111111111111111110111111100000000111111111111111111111111111111111111111111
11111111111111111111111111111111111111111111111111111111110111111100000011111111111111111111111111111111111111111111
11111111111111111111111111111111111111111111111111111111110111111111111111111111111111111111111111111111111111111111
11111111111111111111111111111111111111111111111111111111110111111111111111111111111111111111111111111111111111111111
11111111111111111111111111111111111111111111111111111111110111111111111111111111111111111111111111111111111111111111
11111111111111111111111111111111111111111111111111111111110111111111111111111111111111111111111111111111111111111111
11111111111111111111111111111111111111111111111111111111110111111111111111111111111111111111111111111111111111111111
11111111111111111111111111111111111111111111111111111111110111111111111111111111111111111111111111111111111111111111
11111111111111111111111111111111111111111111111111111111110111111111111111111111111111111111111111111111111111111111
11111111111111111111111111111111111111111111111111111111110111111111111111111111111111111111111111111111111111111111
11111111111111111111111111111111111111111111111111111111110111111111111111111111111111111111111111111111111111111111
11111111111111111111111111111111111111111111111111111111110111111111111111111111111111111111111111111111111111111111
11111111111111111111111111111111111111111111111111111111110111111111111111111111111111111111111111111111111111111111
11111111111111111111111111111111111111111111111111111111110111111111111111111111111111111111111111111111111111111111
11111111111111111111111111111111111111111111111111111111110111111111111111111111111111111111111111111111111111111111
11111111111111111111111111111111111111111111111111111111110111111111111111111111111111111111111111111111111111111111
11111111111111111111111111111111111111111111111111111111110111111111111111111111111111111111111111111111111111111111
11111111111111111111111111111111111111111111111111111111110111111111111111111111111111111111111111111111111111111111
11111111111111111111111111111111111111111111111111111111110111111111111111111111111111111111111111111111111111111111
11111111111111111111111111111111111111111111111111111111110111111111111111111111111111111111111111111111111111111111
11111111111111111111111111111111111111111111111111111111000001111111111111111111111111111111111111111111111111111111
11111111111111111111111111111111111111111111111111111111000011111111111111111111111111111111111111111111111111111111
11111111111111111111111111111111111111111111111111111111000001111111111111111111111111111111111111111111111111111111
1111111111111111111111111111111111111111111111111111111100D001111111111111111111111111111111111111111111111111111111
11111111111111111111111111111111111111111111111111111111000001111111111111111111111111111111111111111111111111111111
11111111111111111111111111111111111111111111111111111111000001111111111111111111111111111111111111111111111111111111
11111111111111111111111111111111111111111111111111111111000001111111111111111111111111111111111111111111111111111111
11111111111111111111111111111111111111111111111111111111000001111111111111111111111111111111111111111111111111111111
11111111111111111111111111111111111111111111111111111111111111111111111111111111111111111111111111111111111111111111
11111111111111111111111111111111111111111111111111111111111111111111111111111111111111111111111111111111111111111111
11111111111111111111111111111111111111111111111111111111111111111111111111111111111111111111111111111111111111111111
