NO      ./graphic/NO.xpm
SO      ./graphic/SO.xpm
WE      ./graphic/WE.xpm
EA      ./graphic/EA.xpm
DO      ./graphic/DO.xpm

F 136,74,118
C 155,246,168

                                                                                                                                                                            
                                                                                                                                                                            
                                                                                                                                                                            
                                                                                                                                                                            
                                                                                                                                                                            
                                                                                              11                                                                            
                                                                                             100111                                                                         
                                                                                            10000001                                                                        
                                   11111111111111111111111111111111111111111111111111111111100000001                                                                        
                                  100000000000000000000000000000000000000000000000000000000000000001                                                                        
                                  100000000000000000000000000000000000000000000000000000000000000001                                                                        
                                  10000000000000000000000000000000000000000000000000000000000000001                                                                         
                                111000000000000000000000000000000000000000000000000000000000000001                                                                          
                               1000000000000000000000000000000000000000000000000000000000000000001                                                                          
                               1000000001111111111111111111111111111111111111111111111111111000001                                                                          
                               1000D00001                                                  1000001                                                                          
                              110000000011111111111111111111111111111111111111111111111111110000001                                                                         
                             1000000000000000000000000000000000000000000000000000000000000000000001                                                                         
                            11000000000000000000000000000000000000000000000000000000000000000000001                                                                         
                           100000000000000000000000000000000000000000000000000000000000000000000001                                                                         
                           100000000000000000000000000000000000000000000000000000000000000000000001                                                                         
                           100000000000000000000000000000000000000000000000000000000000000000000001                                                                         
                           100000000000011111111111111111111111111111111111111111111111111110000001                                                                         
                           10000000000001                                                   111111                                                                          
                           10000000000001                                                                                                                                   
                           10000000000001                                                                                                                                   
                           10000000000001                                                                                                                                   
                           10000000000001                                                                                                                                   
                           10000000000001                                                                                                                                   
                           10000000000001                                                                                                                                   
                           10000000000001                                                                                                                                   
                           10000000000001                                                                                                                                   
                           10000000000001                                                                                                                                   
                           10000000000001                                                                                                                                   
                         1110000000000001111111111111111111111111111111111111111111111111111111111111111111111111111111111                                                  
                        100000000000000000000000000000000000000000000000000000000000000000000000000000000000000000000000001                                                 
                        1000000000000000000000000000000000000000000000000000000000000000000000000000000000000000000000000011                                                
                        10000000000000000000000000000000000000000000000000000000000000000000000000000000000000000000000000001                                               
                        10000000000000000000000000000000000000000000000000000000000000000000000000000000000000000000000000001                                               
                        1000000000000000000000000000000000N0000000000000000000000000000000000000000000000000000000000000000011                                              
                         111111110000011111111111111111100000000000000000000000000000000011111111111111111111111111110000000001                                             
                                10000000000000000000000000000000000000000000000000000000000000000000000000000000000000000000001                                             
                                10000000000000000000000000000000000000000000000000000000000000000000000000000000000000000000001                                             
                                10000000000000000000000000000000000000000000000000000000000000000000000000000000000000000000001                                             
                                 1100000000000000000000000000000000000000000000000000000000000000000000000000000000000000000001                                             
                                  100000000000000000000000000000000000000000000000000000000000000000000000000000000000000000001                                             
                                   11111111111111111111111111111111111111111111111111111111111111111111111111111111110000000001                                             
                                                                                                                    10000000001                                             
                                                                                                                     111111111                                              
