NO      ./graphic/NO.xpm
SO      ./graphic/SO.xpm
WE      ./graphic/WE.xpm
EA      ./graphic/EA.xpm
DO      ./graphic/DO.xpm

F 81,107,82
C 200,231,250

111111111111111111111111111111111111111111111111111111111111111111111111111111
111111111111111111111111111111111111111111111111111111111111111111111111111111
111111111111111111111110000000001111111111111111111111111111111111111111111111
111111111111111111111110000000001111111111111111111111111111111111111111111111
111111111111111111111110000000001111111111111111111111111111111111111111111111
111111111111111111111110000000001111111111111111111111111111111111111111111111
111111111111111111111110000001001111111111111111111111111111111111111111111111
111111111111111111111110000000001111111111111111111111111111111111111111111111
111111111111111111111110000000001111111111111111111111111111111111111111111111
111111111111111111111110000000001111111111111111111111111111111111111111111111
111111111111111111111110000000001111111111111111111111111111111111111111111111
111111111111111111111111110011111111111111111111111111111111111111111111111111
111111111111111111111111110011111111111111111111111111111111111111111111111111
111111111111111111111111110011111111111111111111111111111111111111111111111111
111111111111111111111111110011111111111111111111111111111111111111111111111111
111111111111111111111111110011111111111111111111111111111111111111111111111111
111111111111111111111111110011111111111111111111111111111111111111111111111111
111111111111111111111111110011111111111111111111111111111111111111111111111111
111111111111111111111111110011111111111111111111111111111111111111111111111111
111111111111111111111111110011111111111111111111111111111111111111111111111111
111111111111111111111111110011111111111111111111111111111111111111111111111111
111111111111111111111111110011111111111111111111111111111111111111111111111111
111100000000011111111111000011111111111111111111111111111111111111111111111111
111100000000011111111111000011111111111111111111111111111111111111111111111111
111100000000011111111111000011111111111111111111111111111111111111111111111111
1111000000000000000000000D0000000000000000000000001111111111111111111111111111
111100000000011111111111000011111111111111111111101111111111111111111111111111
111100000000011111111111000011111111111111111111101111111111111111111111111111
111100000000011111111111000011111111111111111111101111111111111111111111111111
111111110111111111111111000011111111111111111111101111111111111111111111111111
111111110111111111111111100011111111111111111111101111111111111111111111111111
111111110111111111111111100011111111111111111111101111111111111111111111111111
111111110111111111111111100011111111111111111111101111111111111111111111111111
111111110111111111111111100011111111111111111111101111111111111111111111111111
111111110111111111111111100011111111111111111111101111111111111111111111111111
111111110111111111111111100011111111111111111111101111111111111111111111111111
111111110111111111111111100011111111111111111111101111111111111111111111111111
111111110111111111111111100011111111111111111111101111111111111111111111111111
111111110111111111111111100011111111111111111111101111111111111111111111111111
111111110111111111111111100011111111111111111111101111111111111111111111111111
111111110111111111111111100011111111111111111111101111111111111111111111111111
111111110111111111111111100011111111111111111111101111111111111111111111111111
111111110111111111111111100011111111111111111111101111111111111111111111111111
111111110111111111111111100011111111111111111111101111111111111111111111111111
111111110111111111111111100011111111111111111111101111111111111111111111111111
111111110111111111111111101011111111111111111111101111111111111111111111111111
111111110111111111111111100011111111111111111111101111111111111111111111111111
111111110111111111111111100011111111111111111111101111111111111111111111111111
111111110111111111111111100011111111111111111111101111111111111111111111111111
111111110111111111111100000000001111111111111111101111111111111111111111111111
111111110111111111111100000000001111111111111111101111111111111111111111111111
111111110111111111111100000000001111111111111111101111111111111111111111111111
111111110111111111111100000000001111111111111111101111111111111111111111111111
111111110111111111111100000000001111111111111111101111111111111111111111111111
111111110111111111111100000000001111111111111111101111111111111111111111111111
111111110111111111111100000000001111111111111111101111111111111111111111111111
111111110111111111111100000000000000011111111111101111111111111111111111111111
111111110111111111111100000000000000011111111111101111111111111111111111111111
111111110111111111111111101010000000011111111111101111111111111111111111111111
111111110111111111111111101010000000011111111111101111111111111111111111111111
111111110111111111111111100000000000011111111111101111111111111111111111111111
111111110111111111111111111010000000011111111111101111111111111111111111111111
111111110111111111111111111010000000011111111111101111111111111111111111111111
111111110111111111111111111010000000011111111111101111111111111111111111111111
111111110111111111111111111010000000011111111111101111111111111111111111111111
111111110111111111111111111011010111111111111111101111111111111111111111111111
111111110111111111111111111000000111111111111111101111111111111111111111111111
111111110111111111111111111000000111111111111111101111111111111111111111111111
111111110111111111111111111000000111111111111111101111111111111111111111111111
111111110111111111111111111000000111111111111111101111111111111111111111111111
111111110111111111111111111000000111111111111111101111111111111111111111111111
111111110111111111111111111000000111111111111111101111111111111111111111111111
111111110111111111111111111011111111111111111111101111111111111111111111111111
111111110111111111111111111011111111111111111111101111111111111111111111111111
111111110111111111111111111011111111111111111111101111111111111111111111111111
111111110111111111111111111011111111111111111111101111111111111111111111111111
111111110111111111111111111011111111111111111111101111111111111111111111111111
111111110111111111111111111011111111111111111111101111111111111111111111111111
111111110111111111111111111011111111111111111111101111111111111111111111111111
111111110111111111111111111011111111111111111111101111111111111111111111111111
111111110111111111111111111011111111111111111111101111111111111111111111111111
111111110111111111111111111011111111111111111111101111111111111111111111111111
111111110111111111111111111011111111111111111111101111111111111111111111111111
111111110111111111111111111011111111111111111111101111111111111111111111111111
111111110111111111111111111011111111111111111111101111111111111111111111111111
111111110111111111111111111011111111111111111111101111111111111111111111111111
111111110111111111111111111011111111111111111111101111111111111111111111111111
111111110111111111111111111011111111111111111001000000011111111111111111111111
111111110111111111111111111011111111111111111000000000011111111111111111111111
111111110111111111111111111000000000000000000000000000011111111111111111111111
111111110111111111111111111111111111111111111000000000011111111111111111111111
111111110111111111111111111111111111111111111000001000011111111111111111111111
111111110111111111111111111111111111111111111000000000011111111111111111111111
111111110111111111111111111111111111111111111111111111111111111111111111111111
111111110111111111111111111111111111111111111111111111111111111111111111111111
111111110111111111111111111111111111111111111111111111111111111111111111111111
111111110111111111111111111111111111111111111111111111111111111111111111111111
111111110111111111111111111111111111111111111111111111111111111111111111111111
111111110111111111111111111111111111111111111111111111111111111111111111111111
111111110111111111111111111111111111111111111111111111111111111111111111111111
111111110111111111111111111111111111111111111111111111111111111110000001111111
111111110111111111111111111111111111111111111111111111111111111110000001111111
1111111100000000000000000000000000000000000000000000000000000000000N0001111111
111111111111111111111111111111111111111111111111111111111111111110000001111111
111111111111111111111111111111111111111111111111111111111111111110000001111111
111111111111111111111111111111111111111111111111111111111111111111111111111111
111111111111111111111111111111111111111111111111111111111111111111111111111111
111111111111111111111111111111111111111111111111111111111111111111111111111111
111111111111111111111111111111111111111111111111111111111111111111111111111111
111111111111111111111111111111111111111111111111111111111111111111111111111111
111111111111111111111111111111111111111111111111111111111111111111111111111111
111111111111111111111111111111111111111111111111111111111111111111111111111111
111111111111111111111111111111111111111111111111111111111111111111111111111111
