NO      ./graphic/NO.xpm
SO      ./graphic/SO.xpm
WE      ./graphic/WE.xpm
EA      ./graphic/EA.xpm
DO      ./graphic/DO.xpm

F 88,77,84
C 161,164,212

11111111111111111111111
11111111111111111111111
11111111111111111111111
11111111111111111111111
11111111111111111111111
11111111111111111111111
11111111111111111111111
11111111111111111111111
11111111111111111111111
11111111111111111111111
11111111111111111111111
11111111111111000011111
11111111111111000011111
11111110000000000011111
11111110111111000011111
11111110111111000011111
11111110111111101111111
11111110111000001111111
11111110111000001111111
11111110111000001111111
11111110111000001111111
11111110111000001111111
11111110111110111111111
11111111111110111111111
11111110111110111111111
11111110111110111111111
11111110111110111111111
11111110111110111111111
11111110111110111111111
11111110111110111111111
11111110111110111111111
11111110111110111111111
11111110111110111111111
11111110111110111111111
11111110111110111111111
11111110111110111111111
11111110111110111111111
11111110000000111111111
11111110000000001111111
11111110000000101111111
11111110000000101111111
11111110110110101111111
11111110110110101111111
11111110110000000000111
11111110110000000000111
11111110110000000000111
111111101100000D0000111
11111110110000000000111
11110000000000000000111
11110000000000000000111
11110000000000000000111
111100N0000110101111111
11110000001110101111111
11111000001110101111111
11110000001110101111111
11111110111110101111111
11111110111110101111111
11111110111110101111111
11111110111110101111111
11111110111110101111111
11111110111110101111111
11111110111110101111111
11111110111110111111111
11111110111110101111111
11111110111110101111111
11111110111110101111111
11111110111110101111111
11111110111110101111111
11111110111110111111111
11111110111110101111111
11111110111110101111111
11111110111110101111111
11111110111110101111111
11111110111110101111111
11111110111110101111111
11111110111110101111111
11111110111110101111111
11111110111110101111111
11111110111110101111111
11111110111100000001111
11111100000000000001111
11111100111100000001111
11000000000000100001111
11000000000000101111111
11000000000000101111111
11000000000000101111111
11000000000000001111111
11000000000000111111111
11000000000000111111111
11000000000000111111111
11000000000000111111111
11111101111110111111111
11111101111110111111111
11000000000010111111111
11000000000010111111111
11000000000000111111111
11000000000011111111111
11000000000111111111111
11111111111111111111111
11111111111111111111111
11111111111111111111111
11111111111111111111111
11111111111111111111111
11111111111111111111111
11111111111111111111111
11111111111111111111111
11111111111111111111111
11111111111111111111111
11111111111111111111111
