NO      ./graphic/NO.xpm
SO      ./graphic/SO.xpm
WE      ./graphic/WE.xpm
EA      ./graphic/EA.xpm
DO      ./graphic/DO.xpm

F 103,91,185
C 176,249,193

       111111          
      10000001         
     110000001         
    100000W001         
    1000000001         
    1000000001         
    1000000001         
    100000111          
    1000001            
    1000001            
    1000001            
    1000001            
    1000001            
    1000001            
    1000001            
    1000001            
    1000001            
    1000001            
    1000001            
    1000001            
    1000001            
    1000001            
    1000001            
    1000001            
    1000001            
    1000001            
    1000001            
    1000001            
    1000001            
    1000001            
    1000001            
    1000001            
    1000001            
    1000001            
    1000001            
    1000001            
    1000001            
    1000001            
    1000001            
    1000001            
    1000001            
    1000001            
    1000001            
    1000001            
    1000001            
    1000001            
    1000001            
    1000001            
    1000001            
    1000001            
    1000001            
    1000001            
    1000001            
    1000001            
    1000001            
    1000001111111111   
 11110000010000000001  
100000000010000000001  
100000000000000000001  
100000000000000000001  
100000000000000000001  
100000000000000000001  
100000000000000000001  
100000000000000000001  
 10000000000000000001  
 10000000000000000001  
 10000000000000000001  
 10000000000000000001  
 10000000000000000001  
 10000000000000000001  
 10000000000000000001  
 10000000000000000001  
 10000000000000000001  
 10000000000000000001  
 10000000000000000001  
 10000000000000000001  
 10000000000000000001  
 10000000000000000001  
 10000000000000000001  
 10000000000000000001  
 10000000000000000001  
 10000000000000000001  
 10000000000000000001  
 10000000000000000001  
 10000000000000000001  
 1000000000000000011   
 100000000000000001    
 100000000000000001    
 100000000000000001    
 1000000000000000001   
 1000000000000000001   
 1000000000000000001   
 1000000000D00000001   
 1000000000000000001   
 1000000000000000001   
 1000000000000000001   
 1000000000100000001   
 1000000000100000001   
 100000000011111111    
 10000000001           
 10000000001           
 10000000001           
 10000000001           
 10000000001           
 10000000001           
 10000000001           
 1000000000111         
 10000000000001        
 10000000000001        
 10000000000001        
 10000000000001        
 10000000000001        
 10000000000001        
 10000000000001        
 10000000000001        
 1000000000001         
 1000000000001         
  100000000001         
  100000000001         
  100000000001         
   1111111111          
                       
                       
                       
                       
                       
                       
                       
                       
                       
                       
                       
                       
                       
                       
                       
